-------------o--X-------------o----o-------------o------------------------------------------------X------------B--------------------------------------------------------?-------------------------------
---------------------------?-----------------B--------B-----------M-o-------B---B-----o----------------B----o-------B-------------------------------------?---?-------?---------------------------------
-----X-------------B----X-----------------X--o-----------------?-----------o------------o---o--------------X--------?------BX-------o--X-------------------------o----------------BB--------------------
------------------?---------B---o------BB-------o-------------------?--------------------?---B----?------------------X------------------------?----o--------------?--M----------------------------------
--------B---------o--------X------X-----?--o-----o---X--------------------------------------------B---M----------M--?---o-----------?----------------B---X-X---------------B----------------------------
-----?----B-----------XM----------M------M-------X------B-----------o-------X----X------------X------EB---------------o-----------?-----B-------------------X----------------------B------XX--------v---
------------------------?---------------o-------------X---------?-----------MoB-------o------------------------X---BB-----B-X--------?------------------------X------M-------------------XXX--------f---
----------------X------------X--X------------o-----X-------------------B----o--------------------------M---B--o-------oB-------B-----------------M-------B-----o-----X----Xo------M-----XXXX--------f---
----------------------o-------------------?-------------------B--o-------X-----o----------------MM--------------------------------------------B---XB---X---------M--?------------------XXXXX--------f---
-----------------o-o-----------------?-------------------------------B----X----?-------?---M----X---------------------B-------M-T-------M-M---------o------------------X--------------XXXXXX--------f---
--------X---------------?--------------o---------?------------------?--?----B-------------?--?--------------B-------oT--?-------B-----o------MB-|-----X------------------?-----o-----XXXXXXX--------f---
--------X-------o------------------------o---o---?---------------?---o---o------------------o-----------------X---o--|----------|B--------------|--------B--------------M----o----?-XXXXXXXX--------f---
m-----B--------------------E------E----E-------B------E-E---B-----------?--E--E--------------EX----E-E--E----E----E--|--EB-?E---|-----E--XE-----|-E---------X----EE----E------------XXXXXXXX--------X---
XXX-X-XXXXXX-XXXX-XXXXX-XX----XXX-X--XXXX-XXXXXXXXX-XXXXXXXXXXXXXXXX-XX-XX-XXX-X-XXXXX--XXX----XXXXXXXX---XX--XXXX-XXXXXXXXXXXX-XXXX--X-XXXXX-XXXXXXXXX-XXXXXX-XXXXXXX-X--X-X-XXXX-XXXXXXXXXXXXXXXXXXXXX
