---B-oB----Xo--?--B-o--oM--o-BB---B--o?----X?-Xo----B---oX---oo-----------MMX--o---?-----XoBM------X-----B-----B----XM---ooM-----B-M-B-----------X-----oE--X-BXo---?--Xo---?-XM--oM-M-BBBo-B----X-M-----
-M-----o-----?---M-?-oB--o-?X----------B--oXXB--M---------------B---------------o---?----?---M----------M--o--?M---o--?---M-B---XB----M-X--B?---o--?--M-M-----BX--X-?B-o--B-X------B-------------B--?---
-?--M-M-------X---?-B---------MBM-X---XX----?--M-?---o---M?M-MM---?-M----B-----B-B--------?--B---M?X-o-X--M-??--B-B-o--o------X----M--------B--E-M--M-----o-X?--o---o---M---?--X--XXo---M-o--B----BB----
-oo?o-o-B-?-B--MBM-----X-----o------B-Xo---E----X-M---B-?-----BoB--X-?---?---?B----?-o-----B-?------X----o--?-?----------?-B-oB----o--X--------X-B?-?-----X---------B?M--M--------MoM---??o--B-B-----?--
-M---------M----------MX--M-?-X--o--X-?-X--X---M----------MMo--XoMX-X---?---------oM?XB?-o------B--?-XX----?-o------?B-----oXo---Bo-E--M-----------?---?--XM--oXB-BoBX-oBo-?------BM?--X-----?M-X--o----
--B----?-o-o--XB?--X--X-M?BE-----B-BXXoX--?-B-X-----o----EX-Bo?-o--o?--o----X-?BB-------?M------o----?o--o-------B---?-??BBo---M----X-X-----?X-M-M--X---M-B--------B-----B----XB--BXEXMX-B----o------M--
-M---XX--oB----?---MXMBBB--X-BX----?-o-XB--X-X----X-o----X-------o-M------o------------o-------M----M-----M??o?--X--?-M-----X--Mo------o----M-M---M--E-B--M--?--X---------BX-------MX--------M-Mo-------
--oM--?---M---?o--B---??-E--B-MX-B?--M--B?--o-BM---o?---E----X-----M------X--M?BX-BM---B--?B-M-----B-EB--------BM---o-B?M--XX---M---X-------?----o--BX-X-----M------------B----X----o--?-?-----X-B?-?--v
---?-X---oB-?-------B-X--B-M---BB--X--M-M---B-----B-?-M-XM-X-MXB?---------B-X--?X-o-XMXXE-----o-----MX-?---B--XBX-?X-X-MM----?MMX-----o----B-?--X-M--XXo----MMo--o--------o---B-------X---MB?o----X?---f
-X-B?-X??---o--BM-----ooBM------BB-X---B-XBMoM-?o------o-B-XBM-X-B-B-o-X--X---?--o-B-?------B----B--B---B--o?--------B-oBo-X---BBB-X-BoXX?-B------BM?B--?-X-Mo------B---M--------B----o-o---XB------M--f
----M--X-MMo----------oM--MX----E-B--E-------XB?-o---BX--?XX---XX-M----B-------Bo--B?o-o-XXB?-?Mo-X-M?---B--X-------o-B--BXX?o-----B--M-MX-B--E---M-M-M-------E----M-o--B?--------??-o-ooM--B---X---?--f
----M?B-?XE-B--X-oM--?--M-o-M---?-o-X--?oo--M-BXo?------Bo----o-o-----BM-BXXBM-XB---MB---M-X----M--?--MXT---B--B---M----X-o---X-?X--oo---XT--------------o-M--MX--------oX--X-?-----X--o---?-o--?BBM---f
-M--------X-o-----X---------M---o--------MM--B--XX-o---------oo?ooo--X?----Xo---X-B?B-X-X--XBM-ooMM--X--X--o-MB??----X---Xo----X-BX---B-BXX-??M--X-----oo-----o----T--o--XX-?----X--|B--X------B----B-Mf
----M-MXo--?----?------------o---o-o-MM?--oE-MX--o--BB--BM-??----X----M-T--??--?-o-?--?B--Xo-M--X---X---o--T----M--MB--MEXo-?--B--------B|X--M--X----XX-----EMM-M--X---o-M--o--M--X-|-XM-X---B--XB-----f
m-E---E-----?--------E--E-X-E----EB?----?--X-E--EB---E--E-?-E--E--E--B-XE-EE--X-BEB--EB------XB-BEEE-E--|EE----|--?-EB--EXE---E--E--E?---XEB----?-----------X-B---B|B--E--EE-E---EEE-E?-----?-------B--X
XXXX-XXXX---XXXXX--XX----X-XXX-XXXXX--------XXXXXX-XX-X-X-XXXXX---X--XXX-XXXX-XX-XXX----XXXX-XXXX-XXX-X-XX--X--X-XXX-XXXX--XX-XXX-XX--X-X-XXXXX------XXX---XX--XXXXXX--XX-XXXXXXXXXX----XXX-X-XXXXX-X-XX
