-----------B-------------------X-X---------------------?-------o------------o----?-------o--X?----B--?-----?--------------------o---------BX---------X-----------o-------?---------B-------M------------
-------X---------M?-----B-----------------------B--B-------------B----------o-----------------------o--B---X------------X-------------------X-o--------?--------o---o--X----X----X----------------------
----------o-----------------B------?-----------------------------o------o--M--------M-----------?--X-------B--XB--?-----?----------------?-------------------o----------------------o-------------------
-----------------?---M------?---B----B-X-------------?----X--X---------B-----X---E----------------X--------X--o--o---------o-------o--X----B--o-----X----XX----------X--X-B---------------B-------------
---------------------B---------B--------------X----------X-----------------------X--B-X--------B----B-----------------MM-B--------B-----M--------??----B----?----------------B---?----------------------
----B----X--------------??------B----?-----B----------?---o----BB--E---X-----M-----------------M--o-----o--B-E--?-----BX----X----X-------X---?------?--------------------------M---B----X---------------
--X------------------------B--------------------------------X------X--?-----------Mo-------B--X--------------?-o---B------B--------------------B---?----M----------------X----M--------B----------------
---------------MXo----------------------------B----------M----B---M-----o-----------B----------------M--o---------------X-----o---?-X-------X--oB---B----X------M-X----?--------------B----------------v
-----------------o-----B-B----BB---M-?-----M---XB-E-------?------X--------B---------------------M----------oo-----B--------?-X----X-X-?-?------?----------------o----X-------------B-------------------f
--B-B-B---------B---B-----B---B-?---X-----------B-B---o--------X?-----------o-------XM----------------?--X---B-M-------------M-?---E--XX-----?--X--------XB------o?----X-?-------o---------------------f
-------BM-----o-X---X-----------M---o---------?--------?-?-------?--?--------------oXo---E---X----B-----X--oM---MM-----??----------B--------------B------?------------------E------?-------------------f
---------?---B--------B---------B--X--?-----------B?--M-----------?-----------B---------MM---X?----------B--------M------TM--X-------------------------------TM------o-?B--BXM---o-oB-----B------------f
----o-----------------T--?-------X-----?-------------------------o------------B----o------B----o-----------XB-----M--B--?|----------o--------B------B-M------|-----M------o----------------------------f
---------M------------|X---------------------T--B----Xo---o-?--B--B---------------o------X-----------------X--X----------|X----o--------------X--------------|X-------------?--------------?-----------f
m----EB----E-B---EBE-EX---E--E--EEE---B-B----|------B---------E--X-?---X---?-B-E-EX------B---------------EE---?--E--E-E--|?--B-E--B--E--------------E-----E--B------EX-------E-EE------E---------------X
XXXXXXXX-X-X--XX--XXX-XX-XXX-XXXXXX--XXX-X-X--XXXXX-XXX-X--XX-XX-XX-X---X-XX-XXXX-XXXXX-XXXXXXX-XXXX-XXX----XX-XXX-XX--X-X-X-----X--X--XX-XXXXXXXXX-XX-XX-XX---X-XX--XXXXXX-X--X---XXX-XX-X-XXXXXXXXXXXX
