---B-oB----Xo--?--B-o--o---o-X------o-?-MM-X---o----B--BoX---oo-----------MMX--o---?-----XX-M----M-X-----B-----B----XM---ooM-------M-B-----E-----X---M--E--X-BXo-X-?--Xo---?-XM--oM-----BX-X----X---?-o-
-M-----------?---M---oB----?B-----X--?BB-o-?B---M---------------B---------------o---?----?---M----------M--o--?M---o--?---B-B---XB----M-X--B?---o--?--M-M-----BX--X-?-----B-X------B--------o--M--B-X---
-?--M-MB------X---?-----------------E-XXB?M-o--M-?---o---M?M-MM---X-M----B-----B-B--------?--B-?-M?--o-X--M-??--B-B-o--o------X-------------B--E-M--M-----o-X?------E---M---?--X--XXX---M-M--B--M-BB----
-oo?o-o-B-?-B---BM-----X------X---?-?-X-M-?-o-?---M---B-------B?B--X-?-o-?---?B----?-o----XB-?----B------o--?-?----------?-B-oB-------X--------X-B?-?-----XB--------B?MB-M-----?--Mo-----?o-MB----o--?--
-M---------M----------MX--o-?-B--oM-----M-?X---M----------MMo--XoMX-X---?--------XBM?XB?--------B--?--X----??o------?BM-M--oXo---Bo-E--M----M------?---?--XM---XB-BoBX-oBE-?------BM?--XX----?M-X--o--o-
--oM---?-o-o--XB?--X----M?BEB------BB-B---?-B-X-----o-o--EX-Bo?----o?--o----X-?BM-------?M------o--?-?o--o-----------?-??BBo---M---MX-X--?--?X-M-M--X---M-B--------B-----B----Xo--BXBX-X-o--X-X---o-B?--
-M---XX--oB----?---MXMBBB--X-----o----------------X-o----X-------o-M----?-M----------B-o---E---M----M-----Mo?o?--X--?-M-----X--Mo------o----M-M---M--E-X-----?--?---------BX-------MX--------o-?o-------
--oM--?---M---?o--B---o?-E--B--X------M-B?--o?BM---o?---E----?-----M------X---?BX-BM---B--?B-M-----B-EB--------BM---o---M--XB-EXM---X-------?----o--BXMX-----M-o----------B---oX--M-o----?-----B-B--?--v
---?-X---oB-X-------B-X--B--M--X---?X---?---oo----B??-M-XM-X--XB?-----M---X-X--?X-o--MXXM-----o-----MXo-------XBX-?X-X--M----?MMX----BM----B-?--X-M--X-o----XM---o--------o---B-------?-X-M-?o---MX?--?f
---B?--E?---?--?M-----ooBX-----XBB?X--BB-XBM-M?-?------o-B-XBM-X-B-B-o-X--X?--?--o-B-?------B----B--B---B--oX--------B-oBo-X---BBX-X-BoXX?-B------BM?B--?-X-Mo--M---BB--M--------B----o-------B-----MB-f
----M-?X--Mo-----------M--MX----XM-o--oB----?B-?-o---BX--?XX---XX-M----B-------Bo-?B?o-o-XXB?-?M?-X-M?---B--X-X-----o-B--BXX?o--M--B--MoMX-B--E---M-M---------E----Moo--B?--------??-o---M------X------f
----M?B-?-E-B--XM?M--?--M-o-------o-M----o----BXo?------oo----o-o-----BM-oXXBM-XB---XB---M-X-B--M--?--MXT---B-EB---M----X-o---X-?X--oo---XT---X---------Bo-M--MX--------oB--X-?-----X--o---?-o--?-B----f
-M--------X-o-----X---B--------?o------B-X-M-BXBX?-----------oo?ooo--X?----Xo---X-B?B-X-X--XBM-o-MM--X--X--o-MB??----X---Xo----X-BX--XB-BXB-?-M--------o------o-E--T-----XX-?----X--|B--X------B--X-B-Mf
----M-MXo--?----?--M--------MM----?o---XM----MXXBX-oBB--BM-?X-X-------M-T--??o-?-o-?--?B---o----X---X---o--T----B--MB--MEXo-?--B--------X||--M-XX----XX-----EMM-M--|---o-o--o--M--X-X-X------X--XB-M-M-f
m-E---E-----?---E----E--E-B--?--EE?----?B--X-E--E----E--E-?-E--E--E--B--E-EE--X-EEB--EB------XB--EEE-E--|EE----|--?-EB--EXE---E--E--E?---XEB----?-------E---X-B---B|B--E--?E-E---EEE|E?-----?-------B--X
XX-X-XXXX---XXXXX--XX----X-XX--X-XXXX------XXXXX-X-XX-X-XX-XXXX---XX-XXX-XXXX-XX-XXX----XXXX-X-XX-XXX-X-XX--X--X-XXX-XX----XX-XXX-XX--X-X-XXXXX------XXX---XXX-XXXXXX--XX-XXXXXXXXXX-----XX-X-XXXXX---XX
