-----------B-------------------X-X----------M----------?-------o-----------------------------?-------------?---B-X------B-------o-M--------?--M------------------o---------B-------B?------M------------
-----------------M?----------------B---------o--B--B--------B----B----------o-------o----------?----o--B---X--X--------MX----------------?--o--------------------------X----X---------------------------
--?-------o--------------------------?---------------------?---X--B--------M---X---------------------------B?-XB--------?---------o------------------o-M--?--o------------------------------------------
------X-X--------?---M----------B----B-X------------------B--?B---?---BB-----X---E---------------------------Mo-------B-M--o--B----?--Xo-?---------------XB----------X--X-B---X--------X--B-------------
---------E---o--o----B------------------------X-----?----------------------------X--B-X--X---?------B----B-X----------M---------------Mo----------?-----B----------?---------B---?M---------------------
----B----X--------------??------B----?-----B------------BB-----BB--E---X--o-----------?--------M-BX-----o--B-E---------X----M----X-------X-M?------B?------X-M-----------M-----B--?--B--X---------------
--X--M-------------------?-----------?--------------?----M--X------X--------------Mo-------B-----------MMB---B-o----------B--------------B------B----------------------X------?M----X--BB---------------
-------------B---o------------X---------------B-----?-X--M-B-MB---M--------o--------X---B---------------o---------------X-----o---------X---M-----------------B---X----?--------------B----------------v
-----------------X-----B-B----M------?-------B-XBME-X-----?B-----X--------BX--------X------M---oM-------B--oo--X--B----------X----B---?----B----o------M--------o----B------------B--------------------f
----B-B---------M---B-----B---B-----XM------------M------------X?E----------o--M----X-----------------?--X---B-M-------------M---o------------X--------?----------?----X-------------------------------f
-----o-BB-----o-X---X--------?----------------?--?----M--?-------?Eo?--?------o----oXM-------X----B-----X--oM-----?----??---X---------------X--Bo-B------?-----?-----------oE--------------------------f
---------?-X-B-----M-?----------------?-----------B---------------?------------------X--XM----?----------Bo--------------TMM---?--X----B---B---o---------XB--T----------B--BX----o-o------B------------f
----o-----------------T--M----B--X-X-M-?-----------------X-------o------------o----------------------------XB-----o--X---|----M----------------B--?-B--------|-----M-----------------------X-----------f
----------------------|X--------B-o---B------B--B--------Bo-?--B--B---------------o------X----------X--------M-----------|-----X--X------o----?-------oXM--B-|X--------X----?--------------?-----------f
m--?-E-----E-B---EBE-EX------E--EEEE----BE---|----E-B--------EE--X-?E--X-----B-E--X------B---------------EE---?--E--E----|?--?-EEBBE?E--------------E----EX--B------E---------BEE-----EE---E-----------X
XXXXXX-X-X-XX-XX---XX-XXXXXXXXXXXXX-X-XXXX-X----XXXXXXX-X--XX-XXXXX-----XXXX-XXXX-XXXXX-XXXX-X--X-XX-XXX----X--X-X-XX-XX-XX------X--X--X---XXXXX-XX--XX-X-XX---X-XX--XXX-XX-X--XX-X-X--XX-X-XXXXXXXXXXXX
