--?-B-------X------o-Xo----o--o---X--?o-?XE-----M-oX?X--X?-MMM---??XBB-oX?--BM--?---?B---BBX-MB---X-?--X?o---B--M-M?-?-B--o--XX----oBBo?-X------EMM-X-MX--X-?-B?--?--B---?--Xo--M-M--MEXMX---------BB-?-
-o----B-M---X?--?M-?-?--M-?-oBB---X-----B-B-BXMo----o-------oXXXB--MX---E-B--oB--B-------oMB-MM?o---?o-M-MM---o-o?M---?MMX-XX-M-M-?-?--EX?MM-XM-X-??-E-o-----XX-o-M--?M---oBEM----XB--B---X?Mo-------MM-
-B-M-M-?X-B--BB---B?-?-?-B--M-E-Eo-----M?XX-o-MX--?----oXo?BX?--?X--?-MX-oB-E??---XB-XM-?oM---X---XM-BBoo-Xo--o?ooXoE-MM-MXoXM----?---M?o-MM-BM-BBo?oB-EoM-X-M-B-----X------M-?-BM?-X-MX-BMBXo---X---X--
-M-MMBM-M?M--M-X--BX-oB?M--o--B??B--o--?X-E-?-o-X-B-------?B-X-----MB?MX-?--?-?-?--?BX-B-B?E----o-B-XX----EB--o-----?M-----?B------MEXM?-X-Mo?-X-------XM--?Bo----o-B---o--B--M--X-o?-M--?----MM---?----
-B-EMo-E-M-MM?oB--oooBM-o-E--XB--MX----B-??-X---M?MM---?-X--?BM---M--oo-B-oB--o-X--B-oXX--MXX---?-M-----oMX-?---XBo----o-BX?M---M---?--B---?-XM-XBE----BXXX--X-XB-B--?-Xo-----XBMX--X---M--oo-----?B----
-o-MM-M?BX---?---?X----MoXXX-Mo----?BX-BM-?E--X----------E-B-M-Xo--M--????-MB-X--o-X--B-?E--oXoBo-?--MXB---o----?-?-BX-?-B----oX-oM-X--o-----BM--oX---o-?-X---o-X--oB-M-EX-X-o-o---B----o-M-MX-BM----B--
-BXXM---B-?MX--o?-B-----B-o-----?EM---B-B-B?-XB-B--XM---MBMXo--M-X---B?oE-?-MMo-?B-o-oB----B---BB--MM-XMoX---?oXM-XXo---M-Xo-----MB--XX-?-B-----M-?Xo-X--?--M-oE-???M?--X--oMX--o--?MM------B-?MXM----?-
-B??B?MBB-B-BBM?---X--M------?--MM-o-?-B-?-B--M--?Mo?--?-oBM-X---X--?---Xo--------o-?-BX-EM-XM----?-?-X-----XMX??--X-?X--BB?B-MXB-XE--?-?-oB--o----ME------?-M-X-o-oX--?E---X--Xo-M--------M-----BXMM--v
-M-X?--oXM-B?B?-Bo-?XX-----B--X--X--X--M-------BB-BB-----M-?----?-o-X--X-BoM-X--o-o-?-B?-o--?M?B---o---B-B-BB-B---o-XBXMoMX----B---o-M-X-XBBBE?-EM--?---X-M-X----MB-?MX-M--B---MXB-M--o-----X-----MX--Bf
-??--B--XMBM-B?M-oo-B--BM-Xo-M---MEo--o---o-------XM?B-o-oXB---o-Mo?XX---M--BXBMo-oB----------?X--ooB?--o?MBBBX-M-M---X?--o---?BB---M-oMM------oX-oM-o----X-?------B-BBooM--------BB----X----X-M-M----of
-M------B?B-X-o-?-ooEM-B--E----X-oMB-X?B-oM---?X---o-XMooB-X-XoB-B?-M-B-?B-?M?----M--X---M--XX----MXM--?X---M---EMX-XMX-BooX-MXX-E---?-o-oB--MBE--B-oM?M-X-o---X-?--M--o--M--o-M--BM--BM?---?M----o---Ef
--X-oB---X-oM?--M-oXX-Mo-EX---?XMM----BX---X-o--B?o----X-B----------oX-X?-oM--?X---B-B?----XX?-o-B-B--X----X-M--M-Xo?--M-oB-o----?---Bo-oX--M--M-X--E-MM-oXM-X-X-?--?M---o--?-MBB--XMMMo---o------M-?-?f
-X?-o---BXM-oMMBMoBB---MB?--oo-B?-MX--X---BMoM-B-----o-M?MXXX---M--X-?X?X-oo-X-X-MoX-----oXB-XM?MXX----MX--B-?E-MXE-XX-o-X-----?-X--o---BoB?-M-BEo-?B----o-?--MX--oX------o--M----X-----X-BME-E-X--o-M?f
-M--?-oBM-----B-B?-X--BB--X?X--M-B---X-M-B--BoBB-?X-E--MMBB--Moo--X--X---M--M-MM--B-E-X------M---MMXM---------X---B?M-o---X-?oX---M---?XM-o---B-X-MM--E-B-M-----o-o-----o|oMBMM|----Mo---?oX?oB--M-----f
mX?-B-EX-X--E--BEE-----BB--?EE-----EEB-?EE?E--E----?--E----?EX--EB-BE?EEEX-X-B-?----?-?EB?X-E-B--?-?BE--E-?E-EEE?E?---E-?-BXEB-EXX----B--B----XE?E-EXXB-X-----EX----X?-E-EB--EE|-?--B--?EX-E?B--B-E-?E-X
X--XXXX-------X--XXXX-X--XXXXX--X-X--XXXX---XX-X--XX--X-X---XXXX-XX--X-X-X-X---X-XXX--XX-X-XXX-X-XXX-XXX-----XX-X-XX-XXX--X----X-XXX--XXX--XXXXX-X-XX-XX-X-XX--XX--XXX--X--X-XX--XXXXX-XX-XX--XXXXX--XXX
