---X---------o----------------o------------------------------B-----B------------------------------o?----X--------?----o--------X----------------------B--------B----------?-----------------------------
---------------------------?-------------M---X----------?--------------------------?---------------------------------B----------------------------?----------------------M------------------------------
---------B-------------------B-----------?----------o-----o------------------------------o-------------------------------------X---M---X----X-------M------------------------------B--------------------
---------?-----?----------X------------B---------X----------------M-------M-??B-----------------------------X----------X----------------------?------------------M------M-------------------------------
------------------o--------X------X------------------------B-------------------------o---------------------M?-o-------------------X------B-------------------------X---M-------B------------------------
-----?---oB-----------X-----------M--------------B------------M-------------------M----o---B------------?-----o-B----B-o-X----------------X----M--------?-------------M--X----------------XX--------v---
---M--------------o------------------------o----------------X----------?--------------------------o--X-----------------------X----B-------------------------------M-------o---X----------XXX--------f---
----------------X------------X--XB------------------o-------------X-----------B------?----------X-B------------X---------------o--B--B-o--?X-------B------------B-----------------------XXXX--------f---
----------------------oB----------o-------B----------------------------------------------------X---X-----------------o-------B-o-------------------------------------------------------XXXXX--------f---
-------------B-----o--X--B----------M-------X-------------------------M------M-----T----X--X--X---------------T---?B--------------------------B--------------------------oo-?---------XXXXXX--------f---
-M----------M----------------------------B------------B---------------------------o|----------X---T-----------B----------B--------M------o-o--------------M------------BX------------XXXXXXX--------f---
------------------------------------------------------------X----------------------X----B-----B?--|-----------X----------------------M---------------------------T--------M---------XXXXXXXX--------f---
m--------------------------E------E------EEB-----E------------E--B-------E---------|---------B----|-----------|?E----------------E----E-----EE-E-----------------X--------E--------EXXXXXXXX--------X---
XXXX-XXXXXXXXXXXX-XXXXX-X--X-XXXX-X--XXXXXXXX--XX-XXXXXXXXXXX-XXX-X--XXXXXXXX-X-XX-XXX-XXXX-X-XXXXXXXXXX-XXXXXXXX-XXXXXXXXXXXX-XXXXXX-XXXX--XXXX-X-XXX-XXXXX-XX-XXXXXX---X-X-XXXX--XXXXXXXXXXXXXXXXXXXXX
