----------B-------M----o-o-o?Xo--oE-X----M-X---o-------Mo----oX-?-X--?---M-----X-?-Bo--X?X?-E--X---X-----B-----B----XM----o----M---M-B--?--o--B--XB-----E-?X-BX---?M--Xo-?-?MB---oMo---BBo-oX---X---?-o-
-Bo---X------?oX-Mo-----B-o-X-----X----B-o-?B---M-------X-o-?B-E--BX---X-B----X----X----M---X-oB------B-M--?X--o--E---?---B-B--XXB----M?X--o?------?E-M-M-----B-o---?----MB-XX-X---B--------o----BB-X---
------MB----------MBo----?-o-o----XME-XX-M--o--M-?-------M?--MM?o-XMM--??B?M-X-----X-X-------B-X--?o-X-X-----?--BMB-o--o------M-----X----------E---MM---o-o--?---M----o-----?--X--X-X---M-M--B----B-----
---?------?-----B-Xo----------------?---M-oMo--E--M---o-B---B-B-B-B--XB------?-----EBoM-B----?-?-----o?---M---B-M---?-?---M--oB-M-----X---o--B-X-M?-?-----B--o----Mo-?-B-----------------Mo-M-B---o--?--
-----------o-B----?--B----o-?-X--o--o-ooX--Xo--M-------o--XBX---oMX-o--X-X--------BM--M-M-----M----B-------?-o--o---BB--X--oX-o--?o-B--M---------B-?---?--XM---??-Bo-X---o--------BB?--XX----?M-X--o--o-
------?X-o----XBBo-X-----?B?-X-----BB-B---?-B-X-----M--M-E-o-o--o--------------?---?-B---oXBo---Xo---?o----------B------?-Bo-X-M----?-X-B---?X-X-M-B----?MB------B-B--X-o------Mo-MXBX-X-o--X---o-?-BMo-
-Xo--X---------B---X--B?---X-B--------------------X-B----o--oXM-?-------B-?X--?----EoMBM---?--------------M--o------o-M-X---X---o------B-o--M-B--------B--MB-B--X---?-----XX--?----XX--------o-?o-------
----------M------o----------B-MX------M-B?--oBBM---o?-B-E----o----MB-X----M----oX----X---B------------B--o--B--?B------XM--XB-B-M-X-BB----M-X----oX----XX----M---------X--B-----M---o----?-----B-oM-?--v
---B------B-X----?--B-X--------B---?----?---o-----B-?o--?o-X-oB-?-o--M---X----BoXo-BB-X-XX--B------MX--?X---X-MBX-?B---Mo---X?-MXB----M----B-?--X-MM--------MMo--o--------o---B---M---X-X?M-?o---MX?--?f
--M-BX-E?--??-?-M---o-B-BX----o-BB--o-B--X?M-M--o------MBM-X-X-?--?-----?BX--X---BoB--X-----?-BX--E-X------o?------B-BXo-o-o---oMM-XoBoXX?-?--M---XM-B-M--X-Mo----B-B---M-------EB----o-------------MB-f
-B---XM?---oM-----B---o---M-------Bo--oB----MB-?-o---BX-B----B--X-----B-??M--M-M---B?-----XX------B-M??---o--M-----B---?--XM-M----B--BM--?-B--B---M--------M-?--MXXM-o--BX------M-X?-o---M------X-----Bf
--X--o----BXBM----MM-B---?--------o-M----o-X--B-o?-E----Mo-oX-M-o---?-BM---Xo?------B---MM---XMo---?X-oXT------M---X---X-o-----B?X----?--XT-B-M-o--------o-M--MX-?----------B-?-B--BX--o---?-o--?-B----f
------?---B-M-B---B-----o---?--?o------T-X-M-B--XX-X-M----M---M?-X-B-X----?-o---------XXXMo-XM--?-B--XM-B--o---E?---B---?-o---oX--?---B---X---M--------X------o----T---M-X-----X----|B--X------B----B-Mf
-B----BX--B---------?-------------?----X-----MX--o--o---B--?XX-----M--?-T?--X---------?B-XB----o----X-?-o--T----B--M--BoXXo-X-?-------o-o|-X-M----?-oXXM----EM-o-X-|o?------M--MM?XoX-X------Xo-XB-M-M-f
m-E---E------BE-EB--X--EEBB-----EEE-E--?B--X-E--EB--X-EBX-XBE--EEEBBX-B-?-?E----X-BB-B?--E--EBE--E-E----|-----E|----E--EEXE-X----B--E----XEBE---------------X-B-B-B|E--E--?E---X-EEE|E?-----?-------B--X
XXXXXXXX--X--XXX---XXX--XX-XXX-XXXXXX------XXXXXXX-XX--XX-XXX-X--XX-X-X-XXXX---XX--X-X--XX---X----XX---XXX-XX--X-XX-XXXXXXXXX-X---XX-XX---XXXXXXXX---XXX--XXXX-XXXXXX-X---XX-XXXXX-X----XXX-X-XXXXX-X-XX
