-----B-X----M----oB-oX-o-o-o-X------?o?--B-X---o----BXoo-----oo-----------XXX--o----X----XX-M--X---?-----B-----B----XM---oo----M---M-B--?--o--B--XB-X-----XX-BX--o-M--Xo-?-?M--B-oM----XBo-X----X---?-o-
-Bo?M--B-----?oX?MXB----B-o-X---B------B-E--B---M------------MX-M-M----X------------?-BB-?B-XM---B----B-M--?X--o--E-M-?---B-B--X?B----M?X--o?------?--M-M-----B-o---?-----B-X--X---B-----?--o----BB-X---
---XX-MX-----M-M--M------?-X---?-MX?E?-X-?M-o--M-?-------M?M-MM---X-MX----Xo?--B-B-M------M--B?B-M?--X-X----??--X-B-o-Bo---------BX-X---------oE---MM---o-o--?---M----o-----?--X-?X-MB--M-M--B----BB----
---?X-B--X?o-o--?-----o--M-XE-------?-X-M---o----oB---o-B-----X-B--X-X--M--?o?--M-X--o-X--------X----o?---M--?B-X-X-?B??--Mo-oB-M-----X---o--B-X-B?-?-----B--o----o--?-B-M---------------?o-MB----o--??-
------o-B--MM---X-o--------o?BX--oB----BX--X--BM--M-o---?XM-o--XoMX-X?-M----------BMB-X?---Xo---B----------?-o--o-M-BB--X--oX-X--?M----M---------B-X---?--XM---??-Bo-?---o--------BB?--XX----?M-X--o--o-
-M--o----o---XX-B--X-----?BE--M----BXoXM--?-B-Xo----o----BX-Bo?--X-o?--o----X--o-o-?-----MMX-B--X----?o-----------------?-Bo---M----?-X-B---?X-X-M-B----?MB----?-B-B--X---------o-MXBM-X-o--X-----?-B?--
-Xo---o----?-M-----XB---MX-----EE---BXB---M-X-----X-o-----B------o-X-X--B-MB-----------B---o---MM--------BM--o----M?X-M-X---X---o------BBo--M-B--------B---B-B------?Mo----X--?----XX--------o-?o-------
----o--oX-Xo----oX--M------?--MXX--X-BM-B?-Mo?BM----?---E---oX-o---MB-----X-----X------B-B?-----------B-----B--?B---?--XM--XB-B-M-X-BB---oM-X----oX----XX----MX--------X--B--------Mo----?-----M-B-----v
----X----MBo---BB---BX----M?B?-B---?----?---oo----B??--??o-X-MX-B-----------X---Xo--?MXXE----X-X---MX--B-X--X--BX-?o---Mo---X?-MBB?---M----B-?--XMMM--------MMo--o--------o---B---M---X-X-M-?o---MX?--?f
--M-X--E?--o---MM-------?XM--X--BBX-oXBB-XBM--?-o------MBM-XBM-X-B-?o?---?X---?X---B---MX---B-B--o?-X------M-------B-B-oBo-o---oM--XoMB-X?-?------XM-B----X-Mo----B-o---MB------EB----o------o-?-M--MB-f
----X-?M---ooB--M-----------?--XX--?--oM-o-??B------XoX-B-XX---X--M---?BB--o----o--M--Mo--XB?-?MX----??---o--M-----B--B?--XM-M----B--XM-B?-B------M?-o-----M-?---XXMoo--BX------M-X?-o---M------X------f
---M?M---------Xo-M--?MM-?----EX-?M--X-o-o----?Xo?B-----Mo-?--ooo-M?--B---XX-M-XBB?-M---MMMX-X-----?X-oXT---B--B---X---B-o--?-MB?X-------XT---M-o--------o-M--MX------o-----B-?-----X--o---?-o--?-B----f
----Mo----XXo-M---X---B-o----------------X?MoXXXX?-M--?------o--ooo--oB----Bo-------B-X-X--XBM----B--XM----o---E----B---?-o---oX-o?-------X-?-M--------X------o----T---M-XB-?--X----|B--X------B----B-Mf
-B----??----MX----XM-o?----------M-M-M-X-----M-X----BB--B-M?-----X-----??--??-M?-o--X-?B--X?X-?o----X-?-o-BT--M-B--MB--oEXoX?-?-------ooo|XX-M----?--XX-----EM---X-|-?------M--MM?XoX-X------X--XB-M--Xf
m-E-------------E------EEBBB---?BBEEE?-?B--X-?--E-E-XX--X-?-E--E--E-EE----EE--X--E---EB--X---EEXEE-E----|-----E|-B-?E-?EEXE-X----B--E-B--XEB------------E---X-B-B-B|EE-E--?E---X-EEB|E?-----?-------B--X
XXXX---X--X-XX-X-X-XX---XX-XXX-XXXXXX------XXXXXXXXXX--XX--XX-X---XX-XXXXXXXX--X-XX--X---XXX-X-XX-XXX--XXX-XX--X-XX-XXXXXXXXX-XX--X--XX---XXXXXXXX---XXX---XXX-XXXXXX-XX--XXXXXXXX------XXX-X-XXXXX-X-XX
