--?BMB------M----oB-o--o-o-o-Xo--oE------M?X---o----B-MoX-oB-oo---------?-X?X--o-------M-X--M--X-------o-X--------o-X----oo----M---M-B--?--o-oB--XB-------XX-BX--o-M--Xo-?-?M--B-oM--B--Bo-X----X---?-o-
-M--M------X-?o-?MX-----B-o-X-----X----B-o-?B---M-------M------X----------X---------?X---?-XMM------B---M--?---o------Bo--B-B--XXB-----XX--o?------?--M-M-----B-o---?-----B-X--X---B--------o----BB-X---
-----BMX----------M------?---o----XME-XX-M--o--M-?---o-X-o?B-MM-----XB----?----B-B-M----B-?--B?--MB--M-X----??X-B-B-oM-----M--M---M-X----------E---MM---o-o--?---M-B--o-----?--X--X-o---M-M--B----BB----
-Bo?---B-X?o-o--?--------B--------X-?---M??Moo----M---o-?-----B-B--X??--B?---?----X--o--B----?-----------B----B-X---------M--oB-M-----X---o--B-X-B?-?-----B--o----o--?-B-----------------?X-MB----o--?--
-MX---o-B--MM---------------?-X--o-----oX--Xo--M-------o--X-X---oMX?X---BX-M--o---BM?-BX--------M--?-------X-o--o---?B-M---oXoo--?o-B--M---------B-X--o?--XM---??-Bo-X---o-M------BB?--XXM---?M-X--o--o-
--o-o----B-----B--oX------BE-------BB-B---?-B-X-----o----X---o------B--o----X------?-B-M??------X----??-?--------B---M--?-Bo?--M----?-X-B---?X-X-M-B----?MB----?-B-B--X---------o-MXBB-X-o--X-----?-??--
-----Xo------------XX-X-MX-X-B--------------------X----?-X---M--B-----?B--M-----------------B-BM----M-----B--o------?---X-M-X---o------B-o--M-BB-------B---B-B--X---?------?--?----XX--------o-?o-------
-----o?oo-M?---XoX---------?BoMX------M-B?--o?BM---o?---X----------M---X--X--?X-X-BM---B-B---------X--B---B-B--?Bo----M-M--XB-B-M-X-BB----M-X----oX----XX----M---------X--B---------o----?-----M-B--?--v
---?--M--MBB---BM----X-B----------------?---o-----M-?--?XM-X-MX-?---------M-X-BX?o---M-XE--------BMMXXoo----X--B?B?B-?-Bo---X?-MXB----M----B-?--X-MM--------MMo--o--------o---B---M---X-X-M-?o---MX?--?f
----X--E??-B---MM-------BX---?o-BB--o-B--X?M-M--o------M-M-X---X--BB-o?---B---??-X-B--B-X---B----B--X------o-------B----Bo-o---oM--XoBoXX?-?--M---XM-B-M--X-Mo----B-o---MB------EB----o--------?----MB-f
------?M---ooB--M---?---?-M-o---X-Bo--o-----MB-?-o---BX-B----B--X-M----B-----------B?o-o--X??-?MX-X-M??---o--M--------?---XM-M----B--BM--?-B------M--------M-?---XXMoo--BX------M-X?-o---M------X-----Bf
--o----X-----?BX--M--?MM-?--------o-M----o-X--B-o?-------o---BM-o-----B-M-X--M-XB---M---M----------?X-oXT------B--XM-B---o-----B?X-------XT---M-o--------o-M--MX------------B-?-----X--o---?-o--?-B----f
-B---o--B-XXo-M--oX---o-o---M--?o-X----T-X-M-B-?X?--XE-------o-M-X---XB----XoM?---X?--X-X?M-BM-------BX--M-o---E?---B---?-o---oX--?---B---X-?-M--------X------o----T---M-XB-?--X----|B--X------B----B-Mf
------?X----MX-----M----------M---?----X-----M---X--BB--B--Bo-M-M-----?-T--?--o--?----?B--X---MX--------o------o---M---?EXo-?-?-------o-o|XX-M----?-oXX-----EM-o-X-|-?------M--MM?XoX-X------X--XB-M---f
m-E-----B-------E------EEBB-E---EEE-E--BB--X-E--E---XE--?---E--EE-E--E--|-EE--XB-EB--BB------XE-EEXEEE--|------|----E-?XEXE-X----B--E----XEB----------------X-B-B-B|E--E--?E---X-EEE|E?-----?-------?--X
XX-X---XXXX-XX-X-X-XX---XX-XXX-XXXXXX------XXXXXXX--X---X-XXX-X--X-X-XXX-XX-X-X--XXX-X--XXXX-X--X-XXX--X-X-XX--XXXXX-X--XXXXX-XX--XX-XX---XXXXXXXX---XXX---XXX-XXXXXX-XX--XX-XXXXX-X----XX--X-XXXXX-X-XX
