-----------B-----------------B---Xo---------M----------?-------o-----------------------------?-------------?---B-X------B-------o-M--------?--M------------------o---------B-------B?------M------------
-----------------M?----------------B---------o--B--B--------B----B----------o-------o---------------o--B---X--X--------oX----------------?-----------------------------X----X---------------------------
------?---o--o-----------------------E---------------------?---X--B--------M---X---------------------------B?-XB--------?---------o------------------o-M--?--o------------------------------------------
----M------------?---E----o----------B-X------------------B--?B---?---BB-----X---E---------------------------Mo-------B-M--o--B----?--X--?---------------XB----------X--X-B---X--------X--B-------------
---------E-----------B--X-----?---------------X-----?----------------------------X--B-X--X---?------B----B-X----------M---------------Mo----------?-----B----------?---------B---?M---------------------
----B----X-------------?-?-----o-----?-----B------------B?-----BB--E---X--o-----------?--------M--X-----o--B-E---------X----M----X-------X-M?------B?------X-M-----------------B--?--B--X---------------
--X---------X---------B-----o----B---?--------------?-------X------X--------------Mo-------B-?---------M-B---B-o----------B--------------B------B-----------------------------?M----X--BB---------------
---------------M-o----X-----------M-----------B-----?----M-B-MB------------o--------X-------------------o---------------X-----o---------X---M-----------------B---X----?--------------B----------------v
-M------M---------B-X--M-B----BM?----?-------B-XBME-X-----?B-----X--------BX--------X------M---oM-------B--oo--X--B----------X----B---?----B----o------M--------o----B---------------------------------f
--B---B---------M-----------?----X--XM------------B------------X?E----------o-------X-----------------?--X---B-M-------------M----------------X--------?----------?----X-------------------------------f
-------BB-----o-B---X------o-----X------------?-------M?-?-------?Eo?--?------o----oXM-------X----B-----X--oM-----?----??---X---------------X--Bo-B------?-----?-----------oE--------------------------f
---------?---B----X--?---------o------?-----------B---------------?------------------X--XM----?----------Bo--------------TMM---?--X--------B---o---------XB--T----------B--BX----o-o------B------------f
----o-----------------T--M------B--X-M-?-----------------X-------o------------o----------------------------XB-----o--X---|----M----------------B--?-B--------|-----M-----------------------X-----------f
---------M----------B-|X-X--?---------B------B--B--------Bo-?--B--B---------------o------X----------X--------M-----------|-----X--X------o----?-------oXM--B-|X--------X----?--------------?-----------f
m----------E-B----BE-EX------E--EE------BE---|----E-B--------EE--X-?E--X-----B-E--X------B---------------EE---?--E--E----|?--?-E-BBE?E--------------E----E---B------E---------BEE-----EE---E-----------X
XXXXXXXX---XX-XX--XXX-XXXXXX-XX-XXX-X-XXXX-X----XXXXXXX-X--XX-XXXXX-----XXXX-XXXX-XXXXX-XXXX-X--XXXX-XXX----X--X-X-XX-XX-XX------X--X--X---XXXXX-XX--XX-X-XX---X-XX--XXXXXX-X--XX-X-X--XX-X-XXXXXXXXXXXX
