---B-B------M----oB-o--o---o-----o---oM---------M-X-B-MoX-B--oo------MB--XMMX--oM--?--X--XX-M--X---X-----Bo----B----XX--?oEM-------MoB-----------X---M--E-?X-BX--o-M--Xo-?-?M--B-oM----BBo-X----X---?-o-
-M--M--------?o-?MX-----B-o-X----BXoo--B-B-EB--EM------oM-------B-----M--X------oB--?----?--XM--------B-M--o--oM---o--?---M-B----B----M-X--BE------?--M-M-----B-o---?-----B-X--X---B--------o----BB-X---
--X---MX----------M------X----------B-XXMXBM---M-?-o-o--Xo??-MM---X----MMB?----B-B-----------B---MB--X-X----??--B-B-o--o------X-?X-B----B---B--E-M-oM---o-o--?---M----o-----?--X--X-X---M-M--B---XBB----
-Bo?--X--X?o-o--?----------X-----o--B-----E??-o--MM---o-o---?-B-B--X-?-M-?----B----?Eo--X----?--E----M----M-?XBo---X-----B-B-o??-X-?--X--------X-B?-?-----B--o----M--?-B-----------E-----?o-MB----o--?--
-MX---o-B--MM------------?--o-o--o--X--oX-Xo------X----X--oMo--XoMX-X---?----M----BM?oB?--------B-?---X----?-o--o---??--X--oXo---Bo-E?-M----o------?-B-?--XM---??-Bo-X---o--------BB?--XX----?M-X--o--o-
--o-o----o----XBB--X------B---------MB---??-B----B--o----X--BoX----o?M-o----X-MBB-------?-------X----?M-----?-M-oB---??X?-Bo---M---XX-X-----?X----------M-B------B-B--Xo-------oo-MXBX-X-o--X-----?-BMo-
-B---Xo--------X---XX-X-------------o-o?-----B-B?------?-M-B---X-o-M--o---M------------X------?Mo---M-----M--oX--X-??---B---XM-oo--M---B----M-M--------B---B-B--X---?-----XX--?----XX--------o-?o-------
------?-o-MB----oX-------X-?B-MX---B-XM-B?-oo-BE-?-o?--XX--------X-M--B---X---XB--BB---X-----M-?------B--------B----o---X--XB--XM-----M-----?----oX-BX-X-----M---------X--B---------o----?-----B-B--?--v
---?-----MB----BB---BX---Xooo--BM-BX-X-B?---o-oM-X-X?--?XM-X--MB?M--------B-X--?Xoo-XMXXE---B------MXXoX---X------?o-X-MM---B?-MX----X-----B-?--X-M-o--o----MMo--o--------o---B---M---X-X-M-?o---MX?--?f
----X--E?--B---MM-------B?---X--BX-XoM-B-X-M-MM-o------MBM-XBB-X-B-B-o-Xo-X---?X-o-B-?------B----M------B--oX---X----B-oBo-X---B-X-X-BoXX?-B-----BB--B----X-Mo----B-o---M-------E-----o-------------MB-f
------?M---ooB-EM------------X--M-M-?-EX-M----XM-o?--BX-B--X-B-XX-M----B-------Bo--BEo-o-XXB?-?MX-B-M?------X-------o-B---XX---------?M-MX-B--E---M-M------M-?---XXMoo--BX------M-X?-o---M------X------f
--o----------?-X--M--?MM----------o-----X--o----T-------?o----o-o-----BMo-XXBM-XB---M----M-----oM--?oBoXT---B--B---M----X--X----?X--oM---XT--?Mo------M--o-M--MX------------B-?-----X--o---?-o--?-B----f
-B-M-oB---XXo-M--oX---?-oo----MXo----XoT---MMB------XE-------?o?ooX--X?----X----X-B?B-XB?--XBM----M--X-BX--o---E?-M----X--o---XX------B--XX---M---------------o----T---M-XB-?--X----|B--X------B----B-Mf
-?--o-?X----MX----MM-------XM--?-X-o----M----B-?----BB--E--?o---------M-T--??Bo?-o---M?--MXM--Mo--X-?---o--TX------M---MEXo-?--B--------X||--M--------o-----EM-oXX-|-?------M--MM?XoX-X------XM-XB-M-M-f
m-E--------X----E------EEXBB--E--EE-X--X-X-X----EE--XEX-?---E--?--E--B-XE-EE--X-BEBE-EB-----BX?-EEXE-E--|E--E--|--?-E---EXE---------E--B-EEE--E-?-------E---X-B-B-B|E--E--?E---X?EEE|E?---E-?-------B--X
XX-X---XX-X-XX-X-X-XX---X--X-XXX-XXX-X--X---XX--XXXXX-XXX-XXXXX---X--XXX-XXXX-XX-XXXX---X-XXXX-XX-XXX--XXX-----X-XXX--XXXX-XX-XXX--X-XX-X-XXXXX-X-X-XXXX---XX--XXXXXX-XX--XX-XXXXX-X----XXX-X-XXXXX-X-XX
