---------------oM--------------X-X--------B------------?-------o-----------------?----------X?----B--?-----?-B-?----------------o--------?-----B---X-------------------------------B---o---M------------
------X----------M?-----B-----------------------B--B-------------B----------o----------------------Bo--B---X------------X---------------M---?-------------------------------X----X---X------------------
---------------?------------B------?-----------------------------o---------M--------M-----------?----------B--XB--------B--B-------------?-------X---------X------X--?---------M---Bo-------------------
-----------------?--?M------?---B----B-X-------------?----X--X---------Bo----X---E----------------X----X------o--?---------o-------o--?-----o------X-----X--X--------M---B--------o-------B-------------
---------E-----------B---------B--o-----------X-----?---X------------------------X--B-X------?-B----B-----------------M-X-------------------X-----------o---B--M---------B---B---?--------X-------------
----B-X--X--------------??------B----?-----B--------------o----BB--E---X-----------------------M--oB-M--o--B-E--------------X----X----------------B---B------?----?------B-----M---B----X---------------
--X------------------------B--------------------------------X------X--?-----------Mo-------B--X--------------B-oM---------B-M-----------------B-------B--------------X--------XM-------B----------------
---------------M-o----------------------------B----------M----B---M-o---------------B-------------------o-------o-------X-----o---?-X----XB-B--?------?-o-------B--oM?----------------B----------------v
-------M------o--------B-B----B----M-?---------XB-E-?-----?------X--------B---------------------M----------oo-----B------B-o-X------X--X-----------X--M-X------E---M--X----X-------B-------------------f
--B-B-B-----B---M---B-----B---B-----X-------------B---o-------oX?-----------o-------X-----------------?--X---B-M-------------M-------o------o--------X-----??-?M-?-B-----B-------o-X-------------------f
---X---BB-----o-X---X------B----M---o---------?--------?-?-------?--?--------------oXo---E---X----B-----X--oM----?-----X?-E-X---------B----------o-------M------------o-?---E------?-?-----------------f
---------X---BM--------------------X--?-----------B?--M-----------?-----------B---------MM---X?-----M----B---X---------M-TM---o-------B-------BM--------Xo-T----o-B-------XBX----o-oB-----B------------f
----o-----------?-----T--?-------X-----?-----------------------B-o--------o---B----o-----------------------XB-----o--B---|-----------------------------B---|B-B-o--X-o-M--?-B--------------X-----------f
---------M--------BX--|X------M--------------T--B-----o---o-?--B--B---------------o------X-----------------X--XB---------|-----o--X--------o---------B-----|----?X------o---?-o------------?-----------f
m----EE--E-E-B---EBEBEX---E--E--EEE---B-B----|------B---------E-XX-?---X---?-B-E-EX------B--E------------EE---?--E--E----|?-E--E--B--E--E---B--E--X--B-----|-----B-E---------E-EE------E-X-------------X
XXXXXXXX-X-XX-XX-XXXX-XX-XXX-XXXX-X--XXX-X-X--XXXXX-XXX-X--XX-XX-XX-X---XXXX-XXXX-XXXXX-XXXXXXX-XXXX-X-X----XX-XXX-XX-XX-XX------X--XXXXX-X-X-XXXX--XXX-X-XXX-XXX-X-X--X-XX----X--XXXX-XX-X-XXXXXXXXXXXX
