-------------o--M----------B---------------------X-----------B-B-?----M-------o------X-------------------------B-----------B-------------------------XM-------------------B----X------------------------
---------------------------?-----------------B-o-------X?-o----X----o-------------------------------M?--o-----------B----------------------------o----B------------------M--M---X-----------------------
-----------------X----------------------o----------Xo--------------------------------------------------?---X--------o-B----B--------o--X------------B-----o--------------M------------------------------
----------o---------------------?------B----------?---XB-----------------------------o--?-----------o----------------o--------------X--------------------o-------M--X--X----o-B-------------------------
-----E-----X-X----oX-------X------X----------------X----o-----------------------------------------o---------------------o-----------B-----B-------------------------------------------------------------
-----?---XB-----------X-----------M-----------B--B-------------B-----M--X-----?-X-----------B-----X-----------o---X---o-----------?M----B--------?--------------X-----M----------o--------XX--------v---
-----------------------------------B-------o---------------BXX-----M--------X--B---------BX-----------B--------X----B--E--B-----o--------?-------------X----------M--------X--?----X-----XXX--------f---
---------E------M----M---X---X--X-o--------------------------------------X--X------?--B-------------------------------oB-------B-------------------X-----------?------------------------XXXX--------f---
-------?-?-------X----o-----X-------------B-B---------------o---------B----X-?-----M----B-?----M------?------------------------------------------?----------B--------X-o------M--------XXXXX--------f---
-----------------o-o-?-----------------B----X-----------------------o-------M--------------o---B--?-X---------------------------T---------B-------------------B--?-------------o------XXXXXX--------f---
--------X---------------?----------------B------o-----B-----BM---?--?------X------------------------oMX-----B--------T--?-------B-------------B-|------M?-M-------------X------------XXXXXXX--------f---
--------X-----------------B----------------X-------?-??-----X--X---o--------X------------B----T-----M-------------o-M|----------|---------------|----------------T--------M--------BXXXXXXXX--------f---
m---E-B--------------------E------E---EEBEEB-----E-----B---E----?---X----B-?--E--------XEEX---E--E--X-------------E--|-----?E---|B----E---E-----|---------B------X--X-----E--------XXXXXXXXX--------X---
XXXXXXX-XXXX-XXXX-XXXXX-XXX--XXXX-X---XXXXX-X--XX-XXXXXXXXXXX----X--XXXX-XX-XXXXXXX-XX-X---XXXXXXXXX-X-X--XX--XX--XXXXXXXXXXXXX-XXX---X--XXXX-XXXXXXXXX--XXXX-X-XXXXXX---X-X-XXXX--XXXXXXXXXXXXXXXXXXXXX
