-----------B-----------------B---X----------o----------?-------o-----------------?----------X?-------?-----?---B-------------------B-------X-------------------------B---X--------B--------M------------
-----------------M?-----------------------------B--B--------B----B----------o-------o---------------o--B---X--X---------X--------X------X------------------o-?o--X----------X---------------------------
------?---o--o-----------------------E-------------------------X-----------M---X---------------------------B--XB--------?---------X-------------X-?-----------------X--M------Mo----oB------------------
----M------------?--------X----------B-X------------------B--?----?----B-----X---E-------o--------X----------Mo------------o----------B------------X-M----?----o-----B----B-----?--B------o-------------
---------E-----------B--------?---------------X-----?----------------------------X--B-X------?------B----B-X----------M-------o-----X---X-X?--?----------o----o--B-----M--------------------------------
----B----X---------------?-----o-----?-----B-------------------BB--E---X--------------?--------M--------o--B-E---------X---------o-Xo----X--------------B---oo?-------------------------X---------------
--X---------X---------B-----o-----------------------?-------X------X--------------Mo-------B-------M---M-----B-o----------B-------------------------------?o-B?---------------M--------B----------------
-?-------------M-o----X----------oM-----------B----------MXB-MB---------------------X-------------------o---------------X---X--------?----------o--oX-X-------?----oM---X----B--------B----------------v
--------M---------B-X--B-B----BM-----?-------B-XB-E-------?------X--------B---------X----------oM-------M--oo-----B----------X-----------?---------?B---------------M--?----------E--------------------f
--B-B-B---------M---B-------?----X--XM------------B------------X?-----------o-------X----------?------?--X---B-M-------------M-B------------X---M------Xo-----X------------X------?X-------------------f
-------BB-----o-X---X------B-----X--o---------?-------M?-?-------?Eo?--------------oXo---E---X----B-----X--oM----?-X---??-----o--------------B--------?M-------B-X-------------------------------------f
---------?---B----X--?---------o------?-----------B---------------?---------------------XM----?----------Bo--------------TMM-----X---Xo?----M-X---M-?------?-------X-----------------B-----------------f
----o-----------------T--M------B------?--------------------X-----?-----------o----------------------------XB-----o--B---|-----M-?----X------B-X-----X--------------X-----o-B?-------------X-----------f
---------B----------B-|X-X--?----X----------oT--B--------Bo-?--B--B?--------------o------X-----------------X-------------|-----o--X--------------B---XB-----------oX-T---M-oB---?X---------------------f
m----------E-B----BE-EX------E--EE------BE---|----E-B---------E--X-?E--X-----B-E-EX------B---------------EE---?--E--E----|?----------E-------E?-EE-X--E-B-E---E-B----|--------EE---?---E---B-----------X
XXXXXXXX---XX-XX--X-X-XXXXXX-XX-XXX-XXXXXX-X--XXXXXXXXX-X--XX-XXXXX-----XXXX-XXXX-XXXXX-XXXXXX--XXXX-XXX----X--X-X-XX-XX-XXX--XX-X--X--X--XXXX---X--XXXX--XX---XXX-XX-XX-XX-X--X--X-XX--X-X-XXXXXXXXXXXX
