-----------------------------B-X?X---------------------?-------o-----------------?----------X?----B--?-----?-B-?--------------X-o-B------?-----B---X-------------------------------B---o---M------------
-----------------M?-----------------------------B--B-----X-------B--------------------o--??---------o--B---X------------X---------------M-----------------M-----------------X----X---X------------------
------?------?-----------------------------------------------------------------B----------------?----------B--XB--------B--B-------------?-------X---------X------X--?--------------o-------------------
------B----------?---M----------B----B-X-----------------B-XB?---?---------------E-o--------------X----X------o--?---------o-------o--?-----o------X-----X--X------------B----------------B-------------
---------E-----------B---------BX-X-----------XB----?------------------X-B-------B----X------?-B----B-----------------M-X-------------------X-----------o---B------------B---B---?--------X-------------
---XB-X--X--------------??-BM---B----?-----B--------o----------oB--E--?X-----------------------M--oB-M--o--B-E--------------X---?X----------------B---B------?-----------B-----M---B----X---------------
------------------------------------------------------------X------X--------------Mo-------B--X--------------B-oM---------B-M-----------------B-------B--------------X--------XM-------B---M------------
---------------M-o-------X------------M-------B----------M----B---Xo------B---------?-------------------o-------o-------X-----o---?-X----XB-B---------?---------B--oM?----------------B----------------v
------------------M----B-B----B----------?---B-XB-E-------?-------------X-B---------------------M---------Moo-----B------B---X------X--X-----------X--M------------M--X----X-------B-------------------f
--B-B-B-------?-M---B-----B-B-B-----X-------------B------------M?-------------------M-----------------?--X---B-M-------------M-------o------oB-------X-----??-?M-?-B-----B-------o-X-------------------f
-------BB-oB--o-X---X---------------o--X------?--------?-?---X---?--?--------------oXo-------X----B-----X--oM----?-----X?-E-X---------B----------o---o---M------------o-?---EX-----?-?-----?-----------f
---------?---B---X--------------------?-----------B-?-------------?----------BB----------M---X?----------B---X---------M-TM---o-------B-------BM--------Xo-T--------------XBX----o-oB-----B------------f
----o-------------?---T--M-------X-----?----?----------------?---o-oB---------B-----M----------------------XB-----o--B---|-----------------------------B---|B-B-o--X---M--?-B--------------X-----------f
---------M------------|X---------------------T--B---------o-??-B--B--------------o-------X-----------------X--XB---------|-----o--X--------o---------B-----|----?X------o---?-o-----?------?-----------f
m-X--E-----E-B---EBE-EX------E?-EEE--BB-B----|------B---------E--X-E---X----E--E?EX------B---------------EE---?--E--E----|?-E--E--B--E--E---B--E--X--B-E---|-----B-E---------E-EE------E-X-------------X
XXXXXXXX-X-XX-XX-XXXX-XX-XXXXXXXXXX-XXX-X--X--XXXXXXXXX-X--XX-XXXXX-X---XXXX-XXXX-XXXXX-XXXXXXX-XXXX-X-X----XX-XXX-XX-XX-XX------X--XXX-X-X-X-XXXX--XXX-X-XXX-XXX-X-X--X-XX----X--XXXX-XX-X-XXXXXXXXXXXX
