-----------B-----------------B---X----------o----------?----------B-------M------?---------M---------?-----?-------M-E----------o------o------M--------------------?-----X--------B--------M------------
-----------------M?-----------------------------B--B------------XB----------o-----------------------o--B---X---------B--X--------X--------------------------X---------?X----X---------------------------
------?------o-----------------------E---------------------------X--------------------------------------X--B--XB--------?-----------------------------------------------------M-----oB------------------
----M------------?---E----X----------B-X-------------------------------B-----X---E-----------X----X----------Mo------------o--X----?--X--?---------------X----------------B-----?--B------B-------------
---------E-----------B--------?---------------X-----?--------M---------------B---M-XBMX------?---B--B-------------B---M---------------Mo----------?---M--------?---X--------------?---------------------
----B----X---------------?-----o-----?-----B--------------------?--E---X----------------------BM-------Bo--B-EB-o----M-X----XBX--X-------X----------?--------------B--------------------X---------------
--X---------X---------B-----o-----------------------?----X--X----B-X--------------Mo------B---X--------M-------o----------B--------------B------B-----------?--------------------------B----------------
---------------M-o----X----------oM-----------B-----?----M-X--B---?--------B--------B-------------------o--------------BX-----o---?---------M-----------------------M--?-----B--------B----------------v
--------M---------B-X--B-B----BM-----?-------B-XB-E--------------oX---------o--------------M----M----o-----o------B---------------B----B---B--B--------M------B-X-----------------E--------------------f
--B-B-B---------M---B-------?----X--XM------------B-------X--o-X?------BM---o-------X------X----------?--X-----M----?--------M----------------X-----------Mo----o-?--------X------?X-------------------f
-------BB-----o-X---X---B--B-----X--o---------?-------M?-?--------M-?--------------oXo-X-E---X----B-o---X---M----?-----??-------------------X--B--B--------------o-------------------------X-----------f
---------?---B----X--?---------o------?-----------B--B--------X--o------------B---?----X-M----?-----------o-----------?--XM-------M------------------X-------T-B--------B-------M----B-----------------f
----o-----------------T--M------B------?----------------------X---------------B--------X---------------X---XB---M-o--B---|--------------o-----------B---------------X-----oX??-------------X-----------f
---------M--M-------B-|X-X--?----------------T--B--------Bo-------B---------------o------X-M-----X---------XM------------o------o--------o----?-------o------|X------------o----?----------------------f
m----------E-B----BE-EX------E--EE------BE---|----E-B--------XE----?---X---E--EE-EX------B---------E------E---?--E--EE---|?--?-E-BB-----------------E--------|------E-?-------EE---?---E---B-----------X
XXXXXXXX---XX-XX--XXX-XXXXXX-XX-XXX-XXXXXX-X--XXX-XXXXX-X--XXXXXXX--X---XXXX-XXXX-XXXXX-XX-XXXX-XXXX-XXX----XX-XXX-XX-XX-XXX-----X--X--X--XXXXXX-XX--XXXX-XXX-XX-XX-XXXX-XX-X--X--X-XX--X-X-XXXXXXXXXXXX
