--?B-B------M----oB-o--o-o-o-X----B--o?----X-----------MoX--Bo-----------X-MB-Xo----X----XX-M--X---X-----B----------XM---oo----M---M-B--?--o-XB--XB-----EX?X-BX--o-M-?Xo-?-?M--B-oM-----Bo-X----X---?-o-
-M--M--------?o-?MX-----B-o-X----------B--o-XB----?----------X--B---?------?-B-E----?--B-?B-XM---B----B-M--?XX-o--E-M-?---B-B--XXB----M?---o?------?--M-M-----B-o---?-----B-X--X---B--------o--M-BB-X---
-----BMX----------M------?----oBM-X-E-XX-------M-X-?----?M?M-MM-----X-----?------?--------?--B?B-M?--X-X----??--X-B-o-Bo------M--?X------------E---MM---ooo--?---M----o-----?--X--X-X---M-M--B----BBM---
-Bo?-----X?o-o--?--------B-----o----B-Xo---?-----MM-B-B-?-----BMB--XB?---?---?----X?-o-XM-------X----o?---M--XB-X---?B?---M--oB-M-----X---o-?B-X-B?-?-----B--o----M--?-B-------?---------?o-MB----o--?--
-MX---o-B--MM----------o----?-X--oM-X-?-X--X---M-----?----XBX---o-M-X-----?--------MB-B?---X----X--B--B----?----?----X-----oX-o--?o-B--M----X----B-X---?--XM---B?-Bo-X---o--------BB?--EX----?M-X--o--o-
--o-o----o-----B--oX-----?BE-------BXXo---?XB-X-X---M----EX--o?----o?-?oX---X---B--?-----M-B----X----?o-----------------?-Bo---M----?-X-B---?X-X-M-B----?-B--------B--X---X----Xo-MXBX-X-o--X-X---o-B?--
-B---XX------------XX-X--X-X-B-----?-E-XE--X----?-X-B----X-----o?o--------M----X-------B---oB--MM?--------M--o----M-o-M-X---X---o------B-o--M-XX-------B---B-B--X---?----?XXo-?--M-XX--------o-?o-------
------?oo-M----XoX---------?B-MX-B?--M--B?-Xo?BM---o?---E------M---M-----BX-----X-oM---B-B?--M-------o?-----B--?B---?--XM--XB-B-M-X-BB--B-M-X----oX----XX----M---------X--B---------o----?-----B-B--?--v
---?--M--MBB---BB----X-B-------BB--?----M---B---X---?-MoXM-X-MX-?-oo----M---XoBXXo--?MXXE----X-----MX--?-X--X--BX-?B---Mo---X?-MBB----M----B-?--X-MM--------MMo--o--------o---B---M---?-X-M-?o---MX?--?f
----X--E??-B---MM-------BX------BB-B---B-XBMoM--o------o-M-X---X-B-o-M----X---?X---B---MB---B-B--BE-X--------X-----B-?-oBo-o---XM--XoMB-X?-?--M---XM-B-M--X-Mo----B-o---M-------EB----o-------------MBXf
------?M---ooB--M---------M-----EoB---o------B-o-o---BX-B-X--BoXXMM--BXB?---------BB?-MX--XB?-?o--B-M??---o--M-----B--B?--XM-M----B--BMX-?-B------M--------X-X---XXMoo--BX------M-X?-o---M------X------f
--X-?--X-----?-X--M--?MM-?----B-?Bo-X---oo--o---T?-------o----M-o-----BMo-XXoMMXB---M---MMM-M------?--oBT---B--B---X---B-o--?--B?X-------XT---M-o-------?o-M---X--o---------B-?-----X--o---?-o--?-B----f
-B---o--B-XXo-M--oX---?-o---M---o----------X-B?-X--------M---oo--?o--XBBo-XXo-----X?B-X-X--XBM----B--XM----o---E?---B---?-o---oX--?-------X---X-B------X------o----T---M-XB-?--X---o|B--X------B--X-B-Mf
------?X----MB-----M---------o----Bo-M-XM-o--M------o?--B--MX---o--o--M-T--?--o--o----?B--XMX-Mo----X-?-o-XT----B--M---oEXo-?-?-------o-o|X--M-E----oMM-----EM-o-X-|-?------M--MM?XoX-X------X--XB-M-M-f
m-E-------------E------EE-B-E----EB?---?X--X-E--E---XE--B-?-E--EE-E--EB-|--E?-X--EB--EBE-X---EEXEE-E----|-----E|----E-?EEXE------B--E----XEBE--B---E--------X-B-B--|E--E--?E-B-X-EEE|E?-----?-------B--X
XX-X---XXXX-XX-X-X-XX---XX-XXX-XXXXXX-------XXXXXX-XX-XXX-XXX-X--XX--X-X--XXX-XX-XXX-XX--XXX-X-XX-XX---XXX-XX--X-XX-XX-XXXXXX-XX--XX-XX---XXXXXXXX---XXX---XX--XXXXXX--X--XX-XXXXX-X-----XX-X-XXXXX---XX
