-------------o--X-------------o----o-------------o------------B------------------------------------------------B---------------------------------------------------o------B----X------------------------
---------------------------?-----------------B--------B-----------M-o-------B---------o----------------B----o-------B-------------------------------------?---?----------M------X-----------------------
-----X-------------B----X-----------------X--o-----------------?-----------o------------o---o--------------X--------?------BX------oo--X-------------------------o-------M---B--------------------------
------------------?---------B---o------BB-------o-------------------?--------------------?---B----?------------------X----------------M-------?----o----------------X--X------B-------------------------
--------B--?------o--------X------X-----?--o-----o---B-------?----------------------------M-----M-B---M----------M--?---o-----------?----------------B---X-X---------------------o----------------------
-----?----B-----------XM----------M------M-------X------B-----------oo------X-X--X------------X------EB---------------o-----------?-----B-------------------X---------B----------o--------XX--------v---
------------------------?---------------o-------------X---------?-----------MoB-------o--M---------------------X---BX-----B-X---?----?------------------------X---M-----------?----------XXX--------f---
----------?-----X------------X--X------------o-----X-------------------B----o--------------X-----------M---Bo-o-------oB-------B-----------------M-------B--?--o------------------------XXXX--------f---
----------------------o-------------------?-------------------B--o-------X-----o----------------MM--------------------------------------------B---XB---X---------MB--X--B--?B-M--------XXXXX--------f---
-----------------o-o-----------------?-------------------------------B----X----?-------?---M-E--X---------------------B-------M-T-------M-M---------o---------------------------------XXXXXX--------f---
--------X---------------?------------o-o---------X------------------?--?----B-------------?--?--------------B-------oT--?B------B-----o------MB-|-----X----o------------X------X-----XXXXXXX--------f---
----?---X-------o------------------------o---o---?---------------?---o---o------------------o-------------M---XM--o--|----------|B--------------|--------B----------------M--------BXXXXXXXX--------f---
m-E---B--E-----------------E------E----E-------B------E-E---B-----------?--E--E--------------E-----E-E--E----E----E--|--EX-?E---|-----E--XE-----|-E---------X----E--X-E---E--------XXXXXXXXX--------X---
XXX-X-XXXXXX-XXXX-XXXXX-XX----XXX-X--XXXX-XXXXXXXXX-XXXXXXXXXXXXXXXX-XX-X--XXX-X-XXXXX--XXX----XXXXXXXX---XX--XXXX-XXXXXXXXXXXX-XXXX--X-XXXXX-XXXXXXXXX-XXXXXX-XXXXXXX---X-X-XXXXX-XXXXXXXXXXXXXXXXXXXXX
