--?BMB------M----oB-o--o-o-o-Xo--oE------M?X---?----B-MoX-oB-oo---------?-X?X--o-------M-X--M--X-------o-X--------o-X----oo----M---M-B--?--o--B--XB-----o-?XXBX--o-M--XoX?-?M--B-oM----BBo-XX---X---?-o-
-M--M------X-?o-?MX-----B-o-X-----X----B-o-?B---M-------M------X----------X---------?X---?-XMM-M----B---M--?-X-o------Bo--B-B--XXB----BXX--o?M-----?--M-M-----B-o---?-----B-X--X---B-------Mo----BBEX---
-----BMX----------M------?---o----XME-XX-M--o--M-?---o-X-o?B-MM-----XB----?--X-B-B-M----B-?--B?--MB--M-X----?oX-B-B-oM-----M--M---M-X----------E---MM---o-o--?---M----o-----?--X--X-X---M-M--B---?BB----
-Bo?---B-X?o-o--?--------B----X---X-?---M??Moo----M---o-?-------B--X??--B?---?----X--o--B----?-----------B----B-X---------M--oB-M-----X---o-MB-X-B?-?-----X----------?-B-----------------?o-------o--?--
-MX---o-B--MM---------------?-X--B-----oX--Xo--M-------o----X---oMX?X---BX-MX-o---BM?-BX--------M--?-------X-o--o---?B-M---oXoo--?o-B--M---------BMX---?-MXM---??-Bo-?o--o--------BB?B-XX----XM-X-----o-
--o-o----B-X---B--oX------BE-------BB-B---?-B-X-----o----X---o------B--o----X------?-B-M??------X----??-?--------B---M--?-Bo?--M----?-X-B---?X-X?M-B-M--?-B------B-Bo-X--------oo-MXBX-X-o--X---X-?--Mo-
-----Xo------------XX-X-MX-X-B--------------------X----?-X--MM--B-----?B--M---X-------------B-BM----M-----B--o------?---X-M-X---o------B-o--M----------B---B-B--X---?-----XX--?----XX--------o-?o-------
-----o?oo-M?---XoX---------?BoMX------M-B?--o?BM----?---X----------M---X--X--?X-X-BM---B-B---------X--B---B-B--?Bo----M-M--XB-B-M-X-BB----M-X----o--o--XX----M---------X--B---------o----?-----B-BMB?--v
---?--M--MBB---BM----X-B----------------?---o-----M-?--?XM-X-MX-M---------M-X-BX?o---M-XE-----o--BMMXXoo----X--B?B?B-?-Bo---X?-MXB----M----BoB--X-MM--------MMo--o--------o---B---M---X-X-M-?o---MX?--?f
----X--E??-B---MX-------BX---?o-BB--o-Bo-X?M-M--o------X-M-X---X---B-o?---B---??-X-B--B-X---B----B--X------o-------B----Bo-o---oM--XoBoXX?-?o-M---XM-B-M--X--o------o---M-------EB----o------X------MB-f
------?M---ooB--M---?---?-M-o---X-Bo--o-----MB-?-o---BX-B----B--X-M----B-----------B?o-o--X??-?MX-X-M??---o--M--------X---XM-M----B--oM--?-B------M-B-?----M-B---XXMoo--BX------M-X?-o---M------X------f
--o----X-----?BX--M--?MM-?--------o-M----o-X--B-o?-------o---BM-o-----B-M-X--M-XB---M---M----------?X-oXT------B--XM-B---o-----B?X-------XT---M-o--------o-X--MX-----M------B-?-----X--o-o-?-o--?-B----f
-B---o--B-XXo-M--oX---o-o---M--?o-X----T-X-M-B-?X?--XE-------o-M-X---XB----XoM?---X?--X-X?M-BM-------BX--M-o---E?---B---?-o---oX--?---B--BX-?-X--o-----o------o----T---M-XB-?--X-B--|B--X------B----B--f
------?X----MX-----M-------B-oM---?----X-----M---X--BB--B--Bo-M-------?-T--?--o--?----?B--X---MX--------o------o---M---?EXo-?-?-------o-o|XX-M----?-oXX-----EM-o-X-|-?------M--MM?XoX-X------X--XB-M-M-f
m-E-----B-------E------E?BB-E---EEE-E--BB--X-E--E---XE--?---E--EE-E--E--|-EE--XB-EB--BB------XE-EEXEEE--|------|--X-E-?XEXE-X----B--EE---XEB---B----E-------X---B-B|E--E--?B---X-EEE|E?----E?-------B--X
XX-X---XXXXXXX-X-X-XX---XX-XXX-XXXXXX------XXXXXXX--X---X-XXX-X--X-X-XXX-XX-X-X--XXX-X--XXXX-X--X-XXX--X-X-XX--XXXXX-X--XXXXX-XX--XX-XX---XXXXXXXX-X-XXX---XXX-XXXXXX-XX--XX-XXXXX-X----XXX-X-XXXXX-X-XX
