-------------------------------X-X---------------------?-------o------------M----?----------X?----B--?-----?-B-?----------------o--------?-----B---X-------------------------------B---o---M------------
------X----------M?-----B-----------------------B--B-------------B-----?----o-----o-----------------o--B---X------------X---------------M-----------------------------------X----X---X------------------
-------M-------?------------B------?-------------------------B---o-----E---M--X-----M-----------?----------B--XB--------B--B-------------?-------X---------X------X--?--------------o-------------------
-----------------?---M------?---B----B-X-------------?----X--X---------B-----X---E------?---------X----X------o--?---------o-------o--?-----o------X-----X--X------------B----------------B-------------
---------E-----------B---------B--------------X-----?----------------------------X--B-X------?-B----B-----------------M-X-------------------X-----------o---B------------B---B---?--------X-------------
----B----X?-------------??------B----?-----B--------------o----BB--E---X-----------------------M--oB-M--o--B-E--------------X----X----------------B---B------?-----------B-----M---B----X---------------
--X------------------------B--------------------------------X------X--?-----------Mo-------B--X--------------B-oM---------B-M-----------------B-------B--------------X--------XM-------B----------------
---------------M-o----------------------------BM---------M----B---M-----------------B-------------------o-------o-------X-----o---?-X----XB-B--?------?---------B--oM?----------------B----------------v
-------M-----------------B----B----M-?---------XB-o-------?------X--------B-------------M-------M----------oo-----B------B---X------X--X-----------X--M------------M--X----X-------B-------------------f
--B-B-B---------M---B-----B---B-----X-------------B---o--------X?-----------o-------X-----------------?--X---B-M-------------M-------o------o--------X-----??-?M-?-B-----B-------o-X-------------------f
---X---BB-----o-X---X-----------M---o---------?--------?-?-------?--?--------------oXo---E---X----B-----X--oM----?-----X?-E-X---------B----------o-------M------------o-?---EX-----?-?-----------------f
-?-------X---BM--------------------X--?-----------B?--M-----------?-----------B---------MM---X?----------B---X---------M-TM---o-------B-------BM--------Xo-T--------------XBX----o-oB-----B------------f
----o-------?---?-----T--?-------X-----?-------M-----------------o------------B----o-----------------------XB-----o--B---|-----------------------------B---|B-B-o--X-o-M--?-B--------------X-----------f
---------M------------|X---------------------T--B-----o---o-?--B----B-------------o------X-----------------X--XB---------|-----o--X--------o---------B-----|----?X------o---?-o------------?-----------f
m----EE--E-E-B---EBE-EX---E--E--EEE---B-B----|------B---------E--X-?---X---?-B-E-EX------B---------------EE---?--E--E----|?-E--E--B--E--E---B--E--X--B-----|-----B-E---------E-EE------E-X-------------X
XXXXXXXX-X-XX-XX-XXXX-XX-XXX-XXXXXX--XXX-X-X--XXXXX-XXX-X--XX-XX-XX-X---XXXX-XX-X-XXXXX-XXXXXXX-XXXX-X-X----XX-XXX-XX-XX-XX------X--XXXXX-X-X-XXXX--XXX-X-XXX-XXX-X-X--X-XX----X--XXXX-XX-X-XXXXXXXXXXXX
