-------------o-o--------------M------------------------------B-B------M-------o--------------M----X------------BM-----------B-------------------------B-------------------?--?--?--o--------------------
---------------------------?-----------------X----------?------X----o-----------------------B----------B---------X--------?--------X-------------B?-------M---------------------o-----------------------
---B-----B-------------------o----------------------o------------------------------------------X--X--B-----X----B---?---M--BX-------o--X----------------------------B--------------B--------------------
-o-------?-----?----------X------------B-?---o------------------------------------------X----Bo---?----o-B-----------X----------------------------------M--------M--------------------------------------
---------------------------X------X-----------?---------------------------------------------------B---------------------o?----------B-----------------o------------?---M-------B------------------------
-----?----B-----------X-----------X----------?---B------o------B-----M--X-----?-X--------------------EB--------?---o--o----B------?-----B--------------X?-------------M--X----------------XX--------v---
------------------o----?-----------------o-o---------------BXX-----M--------X--B---------------------B---------X----B--E--B-X----B------o----o--------------X-----M-------o---o----?-----XXX--------f---
---M------------X------------X--XB----------------o----------------------X-XX------?----X---------B----M-X------------oB-------B-------?--o--------B------------B-----------------------XXXX--------f---
------B---------------oX----------o-------BX----------------o---------B----X-?-----?---B---X----MM----X-------X-------o------------X-----o---M---------------M--M------------B---------XXXXX--------f---
-----------?-------o-----B----------M-------X-----------------------o---------------M-----------?--------------?----------------T-------M--------oM--M-------------------oo-?---------XXXXXX--------f---
------------M-----------o----------------B----o-------B------M---?--?------X-------o----B----?--o-----------B--------T--?-------B-------------B-------o---M-----------M-X------------XXXXXXX--------f---
----o------------------------------M------------------------X---B--o-------------------------M-------------B------o--|X-----X---|B--------------------------o----T--------M-X-------XXXXXXXX--------f---
m---B-------E--------------E------E------EEB-----E---------E----E---X----B-?--E-----E------E--X----E-E------------E--|---B-?E?--|----EE--XE--------------E-------X--------E---E----XXXXXXXXX--------X---
XXXX-XXXXXXXXXXXX-X-XXX-XX-X-X-XXXX--XXXXXXXX--XX-XX----XXXXX----X--XXXX-XX-XXXXXXX-XX-XXXXXX--XXXXXXXX---XX--XX-XXXXXXXXXXXXXX-XXXX--XXXXXXX-XX-X-XXXXXXXXXXXX-X-XXXX---X-X--XXX--XXXXXXXXXXXXXXXXXXXXX
