-------------o----------------o------------------X-----------B-B---------------------X---o-----------------------?---------------------------B-----------o----------------B-----------------------------
---------------------------?-----------------B-o-------X?-o?---X----o--------------------XX---------B------------------?----------------B---?---?-X----------------------X------X-----------------------
-----------------X------------?---------o-----------o----------------o---------------M-----------X--------o--------BX-BX----------BM-----------X----------o--------------M------------------------------
--------------------------------?------B----B----------B--B--------------------------o---------------o--o-X--------B-------------------------------o-------------M--X--X----o-B-------------------------
-----M-----X-X--?-oX-------X------E----?----------------o-------------?---------------------------------B---?---o---o---?--------------------?---o---B----------------E---------------------------------
-----B---XB-----------X-----------M-----B--------B-------------B-M---M--X---E-?-X-----------B----B---B------------------?---X----------?--B---------------------X-----M----------o--------XX--------v---
-----------------------------------M-------o----------------XX-----M--------X--B---------o--------M-X---------B-B----?-B---X----B-----------------------o---------Mo-------X--?----------XXX--------f---
---------E------X-----X------X--X-o----------------------------B---------X-oX------M--B-------B-X-------------?o-------X---------X-----------------------B-----?------------------------XXXX--------f---
-------?-?----X-------o---?---------------B-----------------o---------B----X-?----------B-?----X-X------------?X------?------------------o-------oX----X----B--------X--------M-?------XXXXX--------f---
-----------X-----o-o-M----------------------X-----------------------o----------------------o---B--M----?--X-------------o--B--------------o-B---?---o-o-------B--?--------------?-----XXXXXX--------f---
--------X---------------?----------------B------------B-X----M---?--?------X--------------?-------|B-M--------o-----BX---M-T--------M--o--M-B---------X---M---------?---X------------XXXXXXX--------f---
--------X------------------M---------------X---X---?--?-----X------o---------------------B----o--X|E----------M------------|--------------M--------------B-------T--------M-------?BXXXXXXXX--------f---
m---E-B--------------------E------E-E-EEB-EB-----E---------E----E---X----B-?--E--------XE-E-------|X?-------EE--B-------X--|----------E-E-?------XE------B-------X--X-----EE-------XXXXXXXXX--------X---
XX-XXXXXXXXX-XXXX-XXXXX-XX--XXXXX-X--XXXXXX-X--XX-XXX-XXXXXXX----X--XXXX-XX-XXXXXXX-XX-X---XX-XXX--XX-X-X-XXX--X--XXXX-X-XXX-XXXX-XXXXXXXXXXXX-XXXXXXXX-XXXXX-X-XXX-XX-X-X-X-XXX---XXXXXXXXXXXXXXXXXXXXX
