-X-----------------X--------------------------B-------M---M-Bo-------B---------------------?--------o----------B---------X--B---------------------?--oM-------------------B----X------------------------
---------------------------------------------B------------------------------o---------------------------------------------?----------------------?B----------------------M------X-----------------------
------M---------------X--B------?-?----------o---------------o--B---------o-----------BX-M-------------o---XM-------?------BX-------o--X---------------------------------M---B--------------------------
-------o--?-?E----------------o-------?-o------X--------o-------------------o--X----------M--------------B-----------X--------------------?----------------------M--X--X------B-------------------------
-----X-------B----------------------------?--M-X---B-----o-----X------B-?---X---M--B---------B---------------o----------o-----------B-----------------------o---------------X----o----------------------
--------------?-E----X------B------B--BB----------------BBB---o----------X-B----------M----X---X--?--------?---------------B------?-----B-----------------------X-----B----------o-?------XX--------v---
----------------?----?-----M-------M-------?----------------X---?---X-----------------------------------------------B--E--B-----B-------o--------------X----------M------M----?----------XXX--------f---
------------------?---?--B-----?B-------?----------X-----------------------X------B-----------X-----------------------oB-------------------------X-M----o------?------------------------XXXX--------f---
-------------------------o--------X-------B-------o?-M-------o--B----------------------?---X--B---------------?-------o--M-----------------X----------------B-E---B--X-----?--M--------XXXXX--------f---
-----------------?---o-X-T-------B-------------------------------------M---B--------B----X--------B---?---------B---------o-----T-------M-----------o---------B-----------------------XXXXXX--------f---
----------B--------------|-?-B--------?--B------o---------B---o--M------------?BX--------------------M------B--------T--?-------B-------------B-|-------B-M-------------X------X-----XXXXXXX--------f---
-------------B-X---------|M|--B--------------o--??------------------------------------?--------o------------------o--|X---------|B--------------|----?-----------T--------M--------BXXXXXXXX--------f---
m--------X-----X---X---?-|-E---------E-E-E---B---E-----------------E--------E--E--E-----E--E-E------E------------EE--|---B-?EE--|----EE--XE-----|-----B----------X--X-E---E--------XXXXXXXXX--------X---
XX-XXXXXXXXXXXXXX-X-XXXXXXXXXXXX--X-X---XXXXX-XX--XXXXXXXXXXXX-XXXX-XXXXX-XXXXXXX-X-XX-XXXXXXXXXX-XXX-XX--XX--XXXXXXXXXXXXXXXXX-X-XX--XXXXX-X-XXXXXXX-X--XXXX-X-XXXXXX---X-X-XXXX--XXXXXXXXXXXXXXXXXXXXX
