-MX-B-------X-?-XXXo-X?XX--B-----o----Bo--M-----o----XX--BXBMM-?-?-XMBoo----B---?---?--?-BBX-M----X-?--X?o-----?M--X-?-B--o--XX----BBB??-X---X-oEM--X-X---X-?-B?--?--B---X--X---M-M--X-XMX?M----B--?E-X-
--X-?--oBM--M?---M-?BX--M--oX-MXo-X-o?B-M??--XMB----oX--E-ooo-X----MB?---MBX-BM--?-X-----o-B--M-----?oEMMMM--oo-o?M--o?X?X-XM-MXM-?----E-?-B--M---???--o-E-M-XXXo-M---M---oB-M-----B--X----?Xo---X-BM-M-
---M-X-?X-B?-BM--M?XX--MBX-MB----X-----M?-?oo--X--?-M---oo?X-?-oooB--oBXBoB--M?---X---M-?o----X----M-BB?o-MX--o?oBXoE-oM-MXoXM---B?---M?o-MM-B--BBoBoBo-oM-B-M-B----XX------M-?--M?----BXoBMXo-B--?-----
-oMoMMXX-MM--MX------MB?M--o--B--M-X--MX-oB-?-o-----------?B-------?-MMB---??-?-?--?-X---B?E--B-o-B-o?-----B---B----oB-----?B----X-MEXM?-X-M-?--XXBB--MX---?-o----o-B---o--o-X---X-o?-M--?----MX---M--?-
---E----M--XM-M----------------o--?XX-BX-o-oX--M-oMX---B-X-?-X?-XBB--X-??-o--o--X--XB?XX--MXX---?-X-----oMX-?---XBo----X-BB?----M---?--B---?XXoXXBE----BXXX--X-XX-B--?-Xo-----XBMX--X------o?--X-?-B----
-?XB---BBo-X-----o-B----XBoB---?o-oX-XB-E-X--EX-B--XB----E--?M-XB--XB-X?-?-------o--B-XX-E-----Bo-?X-BXB---o----?--BBX-?-B--oB---oM---X---B--X----Xo?---?MX-X-o-X--oB-M-EX-X-o----------oXXXMX--M-MB--?-
--X-M--MBo?MX--o-?---MM?BEX----ooBM-?XBXXXB--X---?-XE--MM--Xo--M-X---B?oX--?-M--?Boo-oB--B-B--oB---MM--MoX-X-Mo-M-XXo-B-M?Xo-----MX-BXX-?-B-----B-?Xo-?-o-----oE-???-?--X--oMX--o--?MB---X-----MM----o--
---?B---?-B-X-M?-?--ooX--XoX----XBX--X-----B--M-BBMo?----o-?--o--XB?B----o--o-----o----X-EM-XM--B-?-o-X-----BMX??MBX-?XB-BB?B-MXB-XE--?-B--B--o-?--ME---?--?-M-X---oX-??E---M--Xo-MXo-------E?----X---ov
-X--?--?MM-X??o-B--XM--?-BX------X--oM-B-----?MoM-X---B-B-M?-------Xo--X-Bo?MM--o-o-?-X?-o--?M?B---o---BB--BE-B---o-XB-MoMX----B---M-M-oX?BBBE?-EM--?---X-o-X----MB-?M--M--B---MXB-M--o-----X--------X-f
-----B--?MX?---M-ooBB-B-M-Xo-X---?--Mo?---Mo------B-?--o?oX-B?EB-XoMo----B---XB---oB---------B?X-XXoB?--o?-BB-o-M-M-------o---?BB---M-oMB--oXX--X-o-Mo--o-o??------B-BBooM--------BBo---X----X--M?Xoo--f
----EMM-B?B-X-o---M----B--X------Eo-oX--B-B---??-B?oX--oo?-X--MM---?BB?-B-?-MB--X-MMXX---M--X-----XXM--?X---ME-XEMX-XMX-Bo-X--X--E---?-o-oB--M-E--B---MM-XBo---X-?--X--o--M--o-M--BM--?M?o--?oMM--oX--Bf
--M-X--M-M-oM------MB-MMB-XXo---XB??---MM--X-M--BM?-----E--?---M-B--oBo----MMo-X?B-B-Bo----XB?-o---B--X----XMM--M-Bo?--M-oM-o----?---Bo-oX--M--M-X--X-M---XM-X-X-?--?M---o-o?-MBB--XMM-----o---M------?f
-M--o--oB-MX?oMBM-?B---MB-M-oMM---X---M--?BMoo-M?-----XMXMMX----M--o-?XB-oBX?X-X-MoXXXo----B--MoMX-----MXo-B--E-oX--XX-o-X-----?-X--o---BoB?-M-BEoBXB------?B-MX--o?------o--M----X-----XE?M----M----oBf
-X--?--B?---E-B--MBM---BB---B--X-B-o?--M----B?B--?--E--XM-B----o--X------M--M-MM--B---X------?---o-XM------XB-X---BMM-----X-?oXo--M---?XM-o---B-XoMM----B-M?----o-o-EX--o|oMBMM|-o--Mo--??oX?-?--------f
m-?-?EBX-X--XB-BEE--EBBBB--???-----EBB--EE-E-EE----?X--?----E?X-EE-?EEEEE-BBEE-?----?-?EB-X-B-E--?-?BE--E-?E-EEX?E?--EE-?-BXEB-EXX----BB---X-B---E-EXXB--?E---EX----X?BE-EB--EE|-?--B--?-XX-?EE-B--E?--X
X-X-XXXX-X----X--XX-XX--X-XXX--X--XXX-XXXX-XXX----XXXXX-X---X-X--XX-XX-----X-XXXXXXX--XX---X-X-X--X--XXX--XX-XX-XXXX-XX---X----X-XXX--X-X--XXXXX---XX--X-X-XX--XX--XXX--X--X-XX--XXX-X-X--XX--XXXXX-XXXX
