-------------o----------------o------------------X-----B-----B-B--B------------------X------------------------M--?-----------?------M-------B-?-----------------X---------B----X------------------------
---------------------------------------------B-o-------X?-o----X------------------------------------B---------------------------------------------------------B----------M----?-X-----------------------
-----------------X----------------------o----------Xo-------X----------------------B-----?-------X--?-----o--------B-------------------B-----------------------------X----------------------------------
--------------------------------?---------?------------B-----------------------------o---------------o-----------------------X-------------M---------------------B--XB-X------B-------------------------
-----E-----X-X----oX--------------X----------?----------o-----------------------------------------------B---?---o---o-----BB----o---B------------------B------------o------------o----------------------
-----?---XB--------?--X-----?-----M--------------B-------------B-----M--X-----?-X-----------B------------------------------X-----o?-----B------------X--?-----M-X----MM--------M-oo-------XX--------v---
-----------------------------------M-------o---------o------XX-----M--------X--B---------B--------X-----------B-B----?----B-X------B-----M---------X-X------------M-----------?----------XXX--------f---
---------E------X------------X--X-o--------X--------------------X----------oX--X------B-------B-X--M----------?o-------B--------X------------------?------------------------------------XXXX--------f---
-------?o?------------o-----X-------------B-----------------o---------B----X-?-----?-?--B-?----X-X-------------M-----------M--------------------------------B--------X-------oMM-------XXXXX--------f---
---o-------------o-o-M----------------------X-------o---------------o--------------------M-o---B--M---oo------------------------T-------------------M-----------?o------------?-------XXXXXX--------f---
--------X---------------?----------------B------------B-X----M--o?--?------X--------------?-------|--M--M-----o---B-BX--?-------B-------------B-|------B--M--------X----X------------XXXXXXX--------f---
--------X----------------------------------X-------?--------X------o---------------------B----o--X|E----------------------------|---------------|----------------T-----M--M---------XXXXXXXX--------f---
m---E-B--------------------E------E---XEBEEB-----E-?-------E----E---X----B-?--E--------XEEE-------|X?-------EE--B?------BB--E---|-----E---E-----|----------------X--E-----E----E---XXXXXXXXX--------X---
XXXXXXXXXXXX-X-XX--XXXX-XX---XXXX-X--XXXXXX-X--XX-XXXXXXXXXXX----X--XXXX-XX-XXXXXXXXXX-X---XXXXXX--XX-X-X-XXX--XX-XXXXX-XXXXXXXXXXXX--XXXXXXX-XXXX-X-XXXXXXXXXX-XXXXXX---X-X-XXXX--XXXXXXXXXXXXXXXXXXXXX
