-B---oB-BX?M----XoB?--XXM-BM-XB-BX--?B-XXB-M-MB---X-o--o-?BE---M-B--------M---B--XoooXXM-??---MMoBoX?-?--XB--E---?----?o-M-ooo?X---M--?X-o-??--o---B--?-----B-B--MXX-M?oB-X-------B--ooXB-?-XMB-B--o-MX-
----o----XMo-X--B--XM-MB-------XMo-EM--X---B?o-Bo-?B--Xo--?B-X-BM--?B--M-B-M---E-?-Xo-M---?X------XB-----M---M-M------oB---B---?-B-o----o--X----M-o--B-M--M--E--?-Xo?B?-M--M-B---M---M-M-ooXoX-EBE-M--B-
-B-------o-o--BEX--M-B--oB--X?BB--oB----B?MXM--------o-XB--X--o---MM--E------M-X---------X-M-----?XoB-MoM--M---o-X-M?-M------X--B-X----M---o-o---MMBB?--X----X--MX--M--?Bo-M--o-----Eo----MB---B-B--X-M-
---o?BM-----?--?---B-X?-o-BXEBMMMB-M-M--BB-X-?BB-ME-----M-M?-Bo-?-----?-?M-o-----o-X??---X-X-M------?o---------M--o------BBX------BMX--BXXooM---Mo----?B-X-------------M--M--Eo--oo?M-o--M-X-B-oBM--Bo?-
-X---?oM--??-M---?--?Xo-----X-MXM----?-?-o-M-oXB-M----Bo------M----M---------M-o-oE----?-M------?MX--BX---oo-M?M--o--B---?-?---?-M-B-?------o?-----o-XM?-EX--MMXo-----E---XX-M---?o-X------X----M-X-ooX-
-o-----Mo--o--?M-X---?--M?----Xo?-X---M--B-B--?-XX-X?o---M-MM-B?--------X--X-?-MX---X?o?-Bo-?-B----B--?B----M--XXo----MM---X-?--E-X---oE-BX---Mo-XBEMBB-o---M-XX----BMo--?-oBB-oE---BX-X--oo-o-M-?BM--M-
--BM-MM--B--oB-XM-MX--o--X---M--?-M---M--o--o---M?------BM----B---E---?B-?-B------M---------?-o-M?-o-MX-o---o-o---B-----XB-XB--oM?-X--X--BBX---o---X-M--o-----------------BX----M--E?--Mo----o--X-ooM-B-
-o-M-oM-XMMooX--BBo---?------X-MXXMoB---XX-?-----BBoE--?B-XM------BoX------X--oX-----?-o------?-BBo-o?---BXMMoXoo-oX-oBB---X-MM----X-?-BB?XXB-?oBoo--o----XB-X--?-X-?---XBo--oMM-M--XM--XM-M-M-Bo--oM-?v
---?--MM-?EM----?X-MB-M--oXX-?o----B-?-?M--------M?oo-?-X-B--M?B--B---M-B-----B?----B---BBXM-M--M----o-o-oB?--M?-----?-o-oX--X----XoB?--XM-X----o-------?-------oBE?M----ooX---XM-?XXM-BXM--EX---E--oX-f
-BM-BM--M-X---o--E-XMM-o?-MM-M--XXMM?o--M-XB---o---BMoX---XMX----?B-----o-M--MM--BX--B--o-Xo----M------??-XX---BX-X--?---?B-X--?B-M---X?--Moo-------BM-M-M---o--XEX-?-----XM----MM------?--------X--?B?f
-Mo----B--X-----?MX---XoMME--X---?Boo--?--X-M?M---B-oMMM-------M--oo--o-?oo?oX-?o-X---BX-----E---M-M--BB---o-B-B--?-XM--B---B--X-oXX------M--o--o-M---X-X-?-B-M-oMo-oo-----B-Bo----------BM---oM-MB?--Mf
--o-BM-o--?oE--?--M----?----B-XBo----B-X--M-B--B?-M----------XX?-B--MX-------B-?EBEME-XXo?--MB--M---MM-?---Mo-ooo----?------?--X--M-o?o-oX----MBM----?oB-?o-M-M-----o---MEo-------M------B----Bo---?--Mf
---oX-?X--?EX-XM----Xo---?-B--X--?o-?B-B--BM------X-XM?-B----Xo-BM---oB---------BBX-BX?X-E-----X?E--o---B--X?-?-o-----?--X--B?oXMM--X?BX-MM-X----?-B----o?--X?oXMB-X-B?-XMM-----X--X------?-B--XM-M-X--f
---X--oB-o-M-BB-----BB------MB--BBX--o-?-?o-XoB--oB---o--B---B-X-MMX?--M-MB---o---o-M---?X-B-?-M-M---?--B-B-E--oB-E---MM-?-o---?oo--MXX----M-X---B--?M-MoMME---o-X-X?B-MB-?-B----X--o-M?---oX----------f
mX--EEE-----E---E-E-?EE-BEEE-X-EE-EEX---EX?-?EE-B-?E--EXEB--B?-?XE-EEBE--E----EEEEX-E---E------B-EEEE-EE-E?EB--E--B-BB?---XE-E-E?-B-EX-E-E--E-E-B---BEE-B?E?E?B-----E-E--E-EE-XX----E-EE--EE?E-B--EE-B-X
X-XX--XX-X--X--X---X--X-XXX-XX-XXXXX--XX----XXX-XXX-XXX--X------XX--X-X-XX-XX-X-XXXXX------XXXXX-X-XX-XXX--X--X-XXX----X---X---X-XX--XXXXX--X-------X------X-X---X-XXXXX----XXXX--XX-XXX-X---X-XXXXX---X
