--?B-Bo-----M----oB-o--o-o-o-X----B--o?----X-----------MoX--Bo-----------X-MB-Xo----X----XX-M--X---X-----B----------XM---oo----M---M-B--?--o-XB--XB-----EX?X-BX--o-M-?Xo-?-?M--B-oM-----Bo-X----X---?-o-
-M--M--------?o-?MXo-X--B-o-X----------B--o-XB----?----------X--B---?------?---E----?--B-?B-XM---B----B-M--?X--o--E-M-?---B-B--XXB----M?X--o?------?--M-M-----B-o---?-----B-X--X---B--------o--M-BB-X---
-----oMX-----M----M------?----oBM-X-E-XX-------M-X-?-----M?M-MM-----X-----?------?--------?--B?B-M?--X-X----??--X-B-o-Bo------M---X------------E---MM---ooo--?---M----o-----?--X--X-X---M-M--B----BB----
-Bo?-----X?--o--?-----?--B----?-----B-Xo---?---B-MM-B-B-?-----BMB--XB?---?---?----X?-o-XM-------X----o?---M--XB-X---?B?---M--oB-M-----X---o-?B-X-B?-?-----B--o----M--?-B-----------------?o-MB----o--?--
-MX---o-B--MM---------------?-X--oM-X-?-X--X---M-----?----XBX---o-M-X-----?--------MB-B?---X----B--B-------?----o---BX-----oX-o--?o-B--M----X----B-X---?--XM---B?-Bo-X---o--------BB?--XX----?M-X--o--o-
--o-o----o-----B--oX-----?BE-------BXXo---?XB-X-X---M----EX--o?----o?-?oX---X---B--?-----M-X----X----?o-----------------?-Bo---M----?-X-B---?X-X-M-B----?-B------B-B--X---X----Xo-MXBX-X-o--X-X---o-B?--
-BM--o---M---------XX-X-oX-X-B-----?-B-XE--X----?-X-B----X-----o?o--------M----X-------B---oB--MM?--------M--o----M-o-M-X---X---o------B-o--M-X--------B---B-B--X---?----?XX--?--M-XX--------o-?o-------
------?oo-M----XoX?--------?B-MX-B?--M--B?-Xo?BM---o?---E------M---M-----BX-----X-oM---B-B?--M-------oB-----B--?B---?--XM--XB-B-M-X-BB--B-M-X----oX----XX----M---------X--B---------o----?-----B-B--?--v
---?--M--MBB---B-----X-B-------BB--?----M---B---X---?-MoXM-X-MX-?-oo--------XoBXXo--?MXXE----X-----MX--?-X--X--BX-?B---Mo---X?-MBB----M----B-?--X-MM--------MMo--o--------o---B---M---?-X-M-?o---MX?--?f
--M-X--E??-B---MM-------BX------BB-B---B-XBMoM--o------o-M-X---X-B-o-M----X---?X---B---MB---B-B--BE-X--------X-----B-B-oBo-o---XM--XoMB-X?-?--M---XM-B-M--X-Mo----B-o---M-------EB----o-------------MBXf
-o----?M---ooB--M---------M-----EoB---o------B-o-o---BX-B-X--BoXXMM---XB?---------BB?-MX--XB?-?oX-B-M??---o--M-----B--B?--XM-M----B--BMX-?-B------M--------M-X---XXMoo--BX------M-X?-o---M------X------f
--o----X-----?-X--M--?MM--------?-o-----oo--o---T?-------o----M-o-----BMo-XXoMMXB---M---MMM-M------?X-oXT---B--B---X---B-o--?--B?X-------XT---M-o-------?o-M---X--o---------B-?-----X--o---?-o--?-B----f
-B---o---?XXo-M---XX--?-o---M---o----------X-B-----------M---oo--?o--XBBo-XXo-----X?B-X-X--XBM----B--XM----o---E?---B---?-o---oX--?-------X---X-B------X------o----T---M-XB-?--X---o|B--X------B--X-B-Mf
------?XX---MX---B-M---------o----Bo-M-XM-o--M------oB--B--MX---o--o--M-T--?--o--o--X-?B--X?X-Mo----X-?-o-XT----B--M---oEXo-?-?-------o-o|XX-M-E----oXM-----EM-o-X-|-?------M--MM?XoX-X------X--XB-M-M-f
m-E-------------EE-----EEBB-E----EB?---?X--X-E--E---XE--B-?-E--EE-E--EB-|--E?-X--EB--EBE-X---EEXEE-E----|-----E|----E-?EEXE------B--E----XEB---B---E--------X-B-B--|E--E--?E-B-X-EEE|E?-----?-------B--X
XX-X---XXXX-XX-X-X-XX---XX-XXX-XXXXXX-------XXXXXX-XX-XXX-XXX-X--XX--X-X--XXX-XX-XXX-XX--XXX-X-XX-XX---XXX-XX--X-XX-XX-XXXXXX-XX--XX-XX---XXXXXXXX---XXX---XX--XXXXXX--X--XX-XXXXX-X-----XX-X-XXXXX---XX
