-----------B-----------------B---X----------o----------?-------o-------?---------?----------X?----X--?-----?---B----------------o-------------M-M---------M--------------X--------B--------M------------
------X----------M?-----------------------------B--B-o------B----B----------o-------o----o----------o--B---X--X---------X-----------------------------B?------------------------------------------------
-----B----o--o-----------------------E---------o-------M-------X-----------M---X---------------------------B--XB--------?-------------?---------------o------o--------------BM------o-------------------
-B-------------------E----X----------B-X-----?------------B--?----?----B-----X---E----------------X----------Mo------------o--B----?--X--?---------------X-X---o----BX---B-B----o-------X---------------
---------E----M------B--------?-----B---------X-----?----------------------------X--B-X------?------B----B-X----------M---------------MX--o-------?----B--------------------X---------?-----------------
---------X---------------?-----o-----?---?-B-------------------BB--E---X--------------?--------M--------o--?-E---------X----M----X-------X---------BM------X----XM-----o-B--?-----------X---------------
--X---------X---------B-----o-----------------------?-------X------X------B-------M--------B-----------M-----B-o----------B--------------B---o--B----?--Bo---?E-------------X-X--------B----------------
---------------M-o----X-------o--oM-----------B-----?----M-B-MBB--------------------X-------------------o---------------X-----o-------------M-------------XB--?---X-M?------?X--------B-X--?-----------v
-------M----------B-X--B-B----BM-----?-------B-XB-E-------?------X--------B---------X----------oM----------o?----------------Xo---B---?----B----o-----M--o------o-----X-------B------------------------f
--B-BBB---------M---B-------?----X--XM------------?------------M?-----------o-------X-----------------?--X---B-M------------------------------X-----X----X---E----?------------X-B?XBB-----------------f
---X---BB-----o-X---X------B-----X--o-----------------M?-?-------?Eo?-------X------oXo---E---X----B-----X--BM----?-----??---X---------------X--Bo-B------?---??---------------X---------B--------------f
---------X---B----X--?-B-------o---B--?-----------B---------------?-o---B------------?--XM----?----------Bo--------------TMM---?--X------------o-------------T-------?X-------M---B--------------------f
----oB----------------T--M------B------?--o----------------------o------------o----------------------------XB-----o--B---|----M-------------------?-B-M------|-?---X-o?--------------------X-----------f
---------M----------B-|X-X--?------?---------T--B--------Bo-?--B--B?--------------o------X-----------------X-------------|---B-o--X------o----?---------X----|X----------B------?--X-------------------f
m----EE--E-E-B----BE-EX------E--EE------BE---|----E-B---------E--X-?E--X-----B-E-EX-----EB---------------EE---?--E--E----|?--?-E-BB-?E--------------E-----E--??----E-------------------E---E-----------X
XX-XXXXX-X-XX-XX--XXX-XXXXXX-XX-XXX-X-XXXX-X--XXXXXXXXX-X--XX-XXXXX-----XXXX-XXXX--XX-X-XXXXXX--XXXX-XXX----X--X-X-X--XX-XXX-----X--X--X--XXXXXX-XX-XX-XX--XX--X-XXXX--X--XX-XXX-XX-XX-X--XXXXXXXXXXXXXX
