---X--?----o-------------------------------B----------------o?------?-----o----M-------------X------o----?-----M--X--M-------?------M---------?---------------------------B----X------------------------
---------------------------------o-----------X---------------X--------B-----XX-----------------------?-----------------o-------------------------------------------------M------X-----------------------
-------------------X--------------X----X---o--?--B--------------------X-M------oo---?-----M----?B------?---X--------o------------------B-----------------------------X----------------------------------
---------B----------------?---------X------------M-----M---------------------------------?---------------------------X-------X-------------M---------------------MB-X--X------B-------------------------
-----------o----B-----------------X-o-oo---------X-B----?----X---B-B------------------------------B--------------------X---B----o---B-------------------------------------------------------------------
-----B---o--oB----------------X-------------------?-------------------?-o--B------o--------M---X---------------------------X-----o?-----B---------------?-------X-----M----------oo-------XX--------v---
---M---------------------------M---B-------------X--------B----X--------------------?-M----?----B--------------X----B-----B-X------Bo----M---------X-------X----o-M-----------?----------XXX--------f---
---------------M------M--X---------------------------------------------------------X---------------X--------------M----B-------B-------------------?----------------B-------------------XXXX--------f---
------------?-----------------------------B--------M----------o-------------M--?-o-B------------------------------------------------------------------------B--------X--------M----o---XXXXX--------f---
---------B----?-------?--B?--M---------------------------------------------B-??------BB-----------------------------------------T-----X----------------------X---o------?-------------XXXXXX--------f---
-M-----------------------|-T----B-------------------------------------------B?-----------------------M------B--------T--?---MXM-B-------------B-|---B--B--M--------X----X------------XXXXXXX--------f---
-------------B-----------|-|---o-------E-------M--------------------------------?--------|--o---------------------o--|----------|---------------|-----------X----T-----B--M---------XXXXXXXX--------f---
mE---------------X-E-----B-|----?----E-X-E-----------------E---------E-X-E------EE-E-E-XE|---E--------------------E--|---B--X---|-----E--EE-----|----------------X--E-----E--------XXXXXXXXX--------X---
XXXX-XX-XXXXXX-XX-X-XXXXXXXXXXXXX-XXXX-XX-XXX--XX-XXXXXXX-XXXXXXXXX-X-XXXXXXXXX-XXXXX-XX--XX-XXXXXXXXXXX-XX---XX-XXXXXX-XXXXXXX-XXXX--XX-XXXX-X-XX-XXX-XX-XXXXX-XXXXXX---X-X-XXXX--XXXXXXXXXXXXXXXXXXXXX
