-----------B-----------------B---X----------M----------?-------o----------------------------X?-------------?---B----------------o-M-----------M------------------oB------X------?-B--------M------------
-----------------M?--------------------------o--B--B--------B----B----------o-------o---------------o--B---X--X--------oX-----------------------------------X---?----?-X----X---------------------------
------?---o--o-----------------------E-------------------------X-----------M---X---------------------------B--XB--------?---------o------------------o-M-----o-----------X----Mo----oB------------------
----M------------?---E----X----------B-X------------------B--?B---?----B-----X---E----------------X----------Mo------------o--B----?--X--?---------------XB--------------XB-----?--B------o-------------
---------E-----------B--------?---------------X-----?----------------------------X--B-X------?------B----B-X----------M---------------Mo----------?-----B------?----------------------------------------
----B----X---------------?-----o-----?-----B------------B------BB--E---X--------------?--------M--X-----o--B-E---------X----M----X-------X---------B?--------o-----X-X------------------X---------------
--X---------X---------B-----o-----------------------?-------X------X--------------Mo-------B-----------M-B---B-o----------B--------------B------B-----------?------------?----B--------B----------------
---------------M-o----X-----------M-----------B-----?----M-B-MB------------o--------X-------------------o---------------X-----o-------------M----------E---------------?-----B---X----B----------------v
--------M---------B-X--B-B----BM?----?-------B-XB-E-------?B-----X--------BX--------X------M---oM----------oo-----B----------X----B---?----B----o------M------B-X-------------M---E--------------------f
--B-B-B---------M---B-------?----X--XM------------B------------X?E----------o-------X-----------------?--X---B-M-------------M----------------X------------o----o-?--------X------?X-------------------f
-------BB-----o-X---X------B-----X------------?-------M?-?-------?Eo?--?------o----oXM---B---X----B-----X--oM----??----??---X---------------X--Bo-B------?---------------------------------------------f
---------?---B----X--?---------o------?-----------B---------------?---------------------XM----?----------Bo--------------TMM---?--X------------o---------XB--T----------B------------B-----------------f
----o-----------------T--M------B------?-------------------------o------------o----------------------------XB-----o--X---|----M----------------B--?-B--------|-----X------o-B?-------------X-----------f
---------M----------B-|X-X--?----------------T--B--------Bo-?--B--B?--------------o------X-----------------X-------------|-----o--X------o----?-------o-M----XX------------oB---?X--B------------------f
m----------E-B----BE-EX------E--EE------BE---|----E-B---------E--X-?E--X-----B-E-EX------B---------------EE---?--E--E----|?--?-E-BBE?E--------------E--------|------E-B-------EE---?---E---B-----------X
XXXXXXXX---XX-XX--XXX-XXXXXX-XX-XXX-XXXXXX-X--XXXXXXXXX-X--XX-XXXXX-----XXXX-XXXX-XXXXX-XXXXXX--XXXX-XXX----X--X-X-XX-XX-XXX-----X--X--X--XXXXXX-XX--XXXX-XXXX-X-X--XXXXXXX-X--X--X-XX--X-X-XXXXXXXXXXXX
