-------------o------M---------o-o-----------------------------------------o-----------------------X------------B------------B---------------------?--oM---o---------------o----X------------------------
---------------------M-----------o-----------X----------?------------X------B--------------------------B------------------?-----------------------------------------?--X-M-----MX-o---------------------
---------X--X------------------------------o--?----Xo------X-------?--------------------o------------------X-----B--?------BX-------o--X---------------------------------M----E-------------------------
-----------------------------B------X------------?---------------------------------------B---Bo---?------B-----------X------------------o------------------------M--X--X------B-------------------------
-----------X---B--o------B-Mo-----X-XXo---o------B------------------------------------------------B---------------------o-----------B-------------------------------------------------------------------
-----?----B-----------X--------------------------B-----BB------B------------X----?-----B---X---------EB---------------o----B------?-----B---------B-------------X-----------oB---o--------XX--------v---
-----------o-----------?-------M---BX-----------------------o---?---X---B-----B-------o--------------B------?--X----B--E--B-X-----------o------M-------X------?---M---------X-?----o-----XXX--------f---
--B-------------X------------X---------------------B------------M-------------------------?------------o--------------oB-------B-----------------X-M----o-----------------X-----?-------XXXX--------f---
-----Xo-?-------------o-M--------o--------B-----------------------------------------------------MM------------------------------------?---------X-----------B-E------X--B--B--M--------XXXXX--------f---
--------Xo-------o-o-----B--XX-----M----?B----------------------B--------------?B------?---M?---?-------------------------------T-------M-----------o---------B---o--?---o------------XXXXXX--------f---
--------X---------------?-------B---------------------B------B---X--T-----B-B--------------------------o----BM-------T--?-------B-------------B-|-------B-M-------------X---------?--XXXXXXX--------f---
--------?-----------?---------?----------?-----------------BX---X---|-------?---------------o---------------------o--|X---------|B--------------|----?--------------------M--------BXXXXXXXX--------f---
m----X------E------------E-E----?----E-X-E-------E------------------|--E?--E--E---------------X----E--------------B--|---B-?E---|----E?--XE-----|-------E----?---X--X-----E--------XXXXXXXXX--------X---
XXXXXX-XXXXX-XXXX-XXXXX--X----XXX-X-XX-XX-XXX--XX-XXXXXXXXXXX-XXXXX-XXXXXXXXXX-X-XXXXX--XXX-X--XXXXXXXX---XX--XXXXXXXXXXXXXXXXX-XXXXX-XXXXXXX-XXXXXXX-X--XXXX-X-XXXXXX---X-X-XXXX---XXXXXXXXXXXXXXXXXXXX
